Nama,Setoran_Awal,Jangka_Waktu,Bunga,Hasil_Bunga,Hasil_Bunga_Bulan,Total_Hasil_Investasi
Mahdi Nanda,20000000,3,0.015,300000,900000,20900000
Zelaya Nurlaela,19000000,6,0.03,570000,3420000,22420000
Panji Simbolon,15000000,12,0.035,525000,6300000,21300000
Raden Darmawan,7000000,6,0.025,175000,1050000,8050000
Among Simbolon,9000000,6,0.035,315000,1890000,10890000
Galar Firmansyah,17000000,6,0.025,425000,2550000,19550000
Rizki Supriyanto,10000000,6,0.025,250000,1500000,11500000
Salman Purnawarman,14000000,6,0.025,350000,2100000,16100000
Prayoga Wardana,16000000,6,0.025,400000,2400000,18400000
Syahrini Suryatmi,8000000,12,0.03,240000,2880000,10880000
Emas Maheswara,20000000,6,0.02,400000,2400000,22400000
Kasim Haikal,9000000,6,0.015,135000,810000,9810000
Ani Ramadhani,17000000,3,0.035,595000,1785000,18785000
Lasmono Adriansyah,20000000,3,0.025,500000,1500000,21500000
Cahyono Prasetyo,12000000,3,0.025,300000,900000,12900000
Embuh Ahmad,14000000,6,0.035,490000,2940000,16940000
Jindra Marpaung,16000000,6,0.035,560000,3360000,19360000
Joko Nanda,16000000,6,0.03,480000,2880000,18880000
Hardana Prasetya,8000000,12,0.025,200000,2400000,10400000
Bakiono Abimanyu,9000000,6,0.03,270000,1620000,10620000
Mulyono Widodo,20000000,12,0.025,500000,6000000,26000000
Hilda Namaga,9000000,6,0.02,180000,1080000,10080000
Kuncara Firmansyah,19000000,3,0.015,285000,855000,19855000
Kasusra Waluyo,10000000,3,0.035,350000,1050000,11050000
Gangsar Marpaung,14000000,12,0.035,490000,5880000,19880000
Caraka Putra,8000000,6,0.025,200000,1200000,9200000
Empluk Airlangga,11000000,3,0.03,330000,990000,11990000
Cengkir Febian,16000000,6,0.035,560000,3360000,19360000
Aulia Usada,8000000,6,0.025,200000,1200000,9200000
Nasab Sabian,17000000,12,0.025,425000,5100000,22100000
Rahmi Yuliarti,10000000,12,0.035,350000,4200000,14200000
Vero Oktovian,20000000,3,0.035,700000,2100000,22100000
Rafi Putra,19000000,6,0.02,380000,2280000,21280000
Vinsen Samosir,12000000,3,0.015,180000,540000,12540000
Dadi Rendra,7000000,3,0.035,245000,735000,7735000
Kawaca Wacana,20000000,6,0.025,500000,3000000,23000000
Bahuraksa Prabowo,5000000,3,0.025,125000,375000,5375000
Kasiran Wijaya,12000000,3,0.025,300000,900000,12900000
Bagas Darmawan,18000000,6,0.015,270000,1620000,19620000
Safina Utami,14000000,6,0.025,350000,2100000,16100000
Belinda Yuniar,17000000,6,0.015,255000,1530000,18530000
Dirja Pradana,14000000,6,0.015,210000,1260000,15260000
Ajiman Habibi,19000000,6,0.025,475000,2850000,21850000
Putri Novitasari,14000000,6,0.025,350000,2100000,16100000
Kala Salahudin,16000000,3,0.025,400000,1200000,17200000
Maras Mangunsong,10000000,6,0.025,250000,1500000,11500000
Marwata Siregar,15000000,3,0.02,300000,900000,15900000
Umaya Marpaung,17000000,12,0.025,425000,5100000,22100000
Gadis Ardiyanti,19000000,12,0.025,475000,5700000,24700000
Karna Prakasa,9000000,6,0.025,225000,1350000,10350000
Martaka Sihombing,16000000,3,0.035,560000,1680000,17680000
Irnanto Nugroho,15000000,12,0.025,375000,4500000,19500000
Marwata Wibowo,16000000,6,0.035,560000,3360000,19360000
Rafi Lesmana,6000000,6,0.015,90000,540000,6540000
Indira Nasyidah,18000000,3,0.03,540000,1620000,19620000
Saadat Tampubolon,7000000,6,0.035,245000,1470000,8470000
Heryanto Habibi,10000000,3,0.025,250000,750000,10750000
Laras Oktaviani,16000000,6,0.015,240000,1440000,17440000
Paiman Habibi,17000000,6,0.03,510000,3060000,20060000
Rahmat Bagaskara,12000000,12,0.025,300000,3600000,15600000
Ani Ningrum,20000000,6,0.015,300000,1800000,21800000
Estiawan Haikal,17000000,12,0.025,425000,5100000,22100000
Maras Arifin,15000000,6,0.025,375000,2250000,17250000
Raden Sitorus,16000000,3,0.015,240000,720000,16720000
Indah Andini,9000000,12,0.03,270000,3240000,12240000
Dwi Suryatmi,8000000,12,0.015,120000,1440000,9440000
Halim Ardianto,17000000,3,0.02,340000,1020000,18020000
Tasnim Maryadi,19000000,6,0.035,665000,3990000,22990000
Ani Damayanti,10000000,6,0.035,350000,2100000,12100000
Vivi Widiastuti,8000000,12,0.015,120000,1440000,9440000
Ghani Siregar,12000000,6,0.02,240000,1440000,13440000
Karimah Palastri,12000000,3,0.015,180000,540000,12540000
Cinthia Rahmawati,14000000,12,0.035,490000,5880000,19880000
Cinta Ningrum,8000000,12,0.02,160000,1920000,9920000
Karna Purwadi,14000000,6,0.025,350000,2100000,16100000
Viktor Wasita,19000000,6,0.03,570000,3420000,22420000
Rafi Anggriawan,17000000,6,0.025,425000,2550000,19550000
Yuni Wulandari,18000000,12,0.02,360000,4320000,22320000
Tasdik Nugroho,7000000,3,0.025,175000,525000,7525000
Rahmi Farida,17000000,12,0.025,425000,5100000,22100000
Hartana Wacana,12000000,3,0.025,300000,900000,12900000
Lulut Samosir,11000000,3,0.035,385000,1155000,12155000
Hasim Wasita,11000000,6,0.015,165000,990000,11990000
Najib Wibowo,7000000,6,0.035,245000,1470000,8470000
Gandi Siregar,20000000,6,0.03,600000,3600000,23600000
Jarwa Hidayat,18000000,6,0.015,270000,1620000,19620000
Nasrullah Pradipta,16000000,3,0.025,400000,1200000,17200000
Hari Nugraha,16000000,12,0.015,240000,2880000,18880000
Unjani Farida,8000000,6,0.015,120000,720000,8720000
Asirwanda Budiyanto,12000000,3,0.035,420000,1260000,13260000
Yessi Wulandari,14000000,12,0.02,280000,3360000,17360000
Kurnia Putra,19000000,6,0.035,665000,3990000,22990000
Halim Mangunsong,14000000,6,0.035,490000,2940000,16940000
Galur Prayoga,17000000,12,0.015,255000,3060000,20060000
Aulia Aurelia,14000000,12,0.035,490000,5880000,19880000
Jarwi Adhitama,10000000,12,0.02,200000,2400000,12400000
Gara Nababan,17000000,3,0.015,255000,765000,17765000
Respati Kuswoyo,14000000,3,0.025,350000,1050000,15050000
Wira Firgantoro,7000000,3,0.015,105000,315000,7315000
Saiful Supriyanto,20000000,3,0.025,500000,1500000,21500000
Praba Syahreza,7000000,6,0.015,105000,630000,7630000
Among Prasetyo,5000000,6,0.02,100000,600000,5600000
Kayun Nugroho,11000000,6,0.02,220000,1320000,12320000
Jane Anandya,7000000,6,0.025,175000,1050000,8050000
Catur Prabowo,7000000,6,0.025,175000,1050000,8050000
Tri Juwita,5000000,6,0.03,150000,900000,5900000
Maryadi Simanjuntak,9000000,6,0.025,225000,1350000,10350000
Samsul Zulkarnain,14000000,3,0.035,490000,1470000,15470000
Cakrawala Damanik,19000000,12,0.02,380000,4560000,23560000
Gawati Anjani,14000000,6,0.03,420000,2520000,16520000
Kartika Handayani,9000000,6,0.02,180000,1080000,10080000
Praba Rendra,19000000,3,0.02,380000,1140000,20140000
Titin Pudjiastuti,20000000,12,0.025,500000,6000000,26000000
Febi Utami,7000000,6,0.025,175000,1050000,8050000
Wirda Mayasari,17000000,6,0.015,255000,1530000,18530000
Adika Abiputra,14000000,6,0.025,350000,2100000,16100000
Halim Mansur,12000000,6,0.03,360000,2160000,14160000
Jayadi Salahudin,10000000,6,0.035,350000,2100000,12100000
Karna Ahmad,19000000,3,0.025,475000,1425000,20425000
Shania Saputri,18000000,3,0.015,270000,810000,18810000
Maida Fernanda,10000000,6,0.025,250000,1500000,11500000
Karsana Firgantoro,9000000,3,0.015,135000,405000,9405000
Purwanto Handoko,15000000,6,0.015,225000,1350000,16350000
Aisyah Fujiati,5000000,12,0.025,125000,1500000,6500000
Jais Prasetyo,17000000,6,0.03,510000,3060000,20060000
Prasetya Tampubolon,18000000,6,0.025,450000,2700000,20700000
Asmianto Sinaga,18000000,12,0.035,630000,7560000,25560000
Bahuraksa Saptono,18000000,12,0.025,450000,5400000,23400000
Asirwada Fabian,7000000,3,0.035,245000,735000,7735000
Maria Mulyani,19000000,3,0.035,665000,1995000,20995000
Jefri Hidayat,11000000,6,0.03,330000,1980000,12980000
Novita Putri,10000000,12,0.025,250000,3000000,13000000
Tira Kusuma,5000000,3,0.025,125000,375000,5375000
Sasha Andriani,14000000,12,0.025,350000,4200000,18200000
Cakrajiya Iswahyudi,10000000,3,0.025,250000,750000,10750000
Devi Rahmawati,15000000,6,0.025,375000,2250000,17250000
Paiman Najmudin,16000000,3,0.035,560000,1680000,17680000
Linda Rahmawati,20000000,3,0.03,600000,1800000,21800000
Ridwan Megantara,8000000,3,0.025,200000,600000,8600000
Yunita Maharani,17000000,3,0.015,255000,765000,17765000
Digdaya Iswahyudi,16000000,6,0.025,400000,2400000,18400000
Rosa Azizah,8000000,3,0.035,280000,840000,8840000
Ratih Laksmiwati,16000000,6,0.025,400000,2400000,18400000
Omar Nugroho,5000000,6,0.035,175000,1050000,6050000
Ajeng Wahyuni,18000000,3,0.02,360000,1080000,19080000
Kusuma Saragih,9000000,6,0.03,270000,1620000,10620000
Saiful Mandala,19000000,3,0.035,665000,1995000,20995000
Hartana Kurniawan,20000000,6,0.015,300000,1800000,21800000
Viktor Prasasta,10000000,6,0.02,200000,1200000,11200000
Jane Azizah,15000000,3,0.015,225000,675000,15675000
Jaya Siregar,19000000,6,0.025,475000,2850000,21850000
Karen Anandya,17000000,6,0.035,595000,3570000,20570000
Marsudi Sitompul,18000000,3,0.025,450000,1350000,19350000
Aisyah Zahrah,10000000,6,0.025,250000,1500000,11500000
Fitri Nurlaela,20000000,3,0.025,500000,1500000,21500000
Mahesa Winarno,11000000,3,0.025,275000,825000,11825000
Jabal Mustofa,16000000,12,0.035,560000,6720000,22720000
Cici Ananda,10000000,12,0.025,250000,3000000,13000000
Warsita Firgantoro,12000000,3,0.015,180000,540000,12540000
Paiman Gunarto,8000000,6,0.025,200000,1200000,9200000
Garang Tampubolon,20000000,12,0.015,300000,3600000,23600000
Cayadi Syahreza,6000000,6,0.025,150000,900000,6900000
Lanang Sitompul,16000000,3,0.035,560000,1680000,17680000
Putri Putri,5000000,6,0.015,75000,450000,5450000
Jarwa Mangunsong,16000000,12,0.02,320000,3840000,19840000
Gilang Latupono,15000000,12,0.015,225000,2700000,17700000
Juli Salma,8000000,6,0.02,160000,960000,8960000
Galur Utama,9000000,6,0.03,270000,1620000,10620000
Malika Wahyuni,12000000,3,0.025,300000,900000,12900000
Dadap Pranowo,8000000,6,0.025,200000,1200000,9200000
Faizah Purnama,14000000,6,0.035,490000,2940000,16940000
Patricia Amanta,14000000,3,0.035,490000,1470000,15470000
Padmi Astuti,14000000,6,0.035,490000,2940000,16940000
Jarwadi Tarihoran,17000000,12,0.025,425000,5100000,22100000
Pandu Nugraha,18000000,3,0.02,360000,1080000,19080000
Jagaraga Mangunsong,14000000,3,0.025,350000,1050000,15050000
Azalea Melinda,14000000,3,0.025,350000,1050000,15050000
Olga Prasasta,9000000,3,0.025,225000,675000,9675000
Zamira Ardiyanti,16000000,6,0.02,320000,1920000,17920000
Prabu Sihombing,5000000,12,0.025,125000,1500000,6500000
Tira Maheswari,10000000,6,0.03,300000,1800000,11800000
Harsanto Alamsyah,9000000,3,0.02,180000,540000,9540000
Ophelia Anandya,7000000,6,0.02,140000,840000,7840000
Paulin Harini,7000000,12,0.025,175000,2100000,9100000
Maida Rahimah,11000000,6,0.025,275000,1650000,12650000
Jefri Situmorang,11000000,6,0.035,385000,2310000,13310000
Balidin Megantara,18000000,3,0.025,450000,1350000,19350000
Labuh Dirgantara,20000000,3,0.02,400000,1200000,21200000
Tirtayasa Manullang,16000000,12,0.035,560000,6720000,22720000
Galuh Mandala,18000000,12,0.03,540000,6480000,24480000
Tasnim Mansur,6000000,6,0.035,210000,1260000,7260000
Liman Pranowo,15000000,3,0.03,450000,1350000,16350000
Dono Aswandi,10000000,6,0.035,350000,2100000,12100000
Nilam Halimah,18000000,6,0.03,540000,3240000,21240000
Dadap Himawan,5000000,6,0.015,75000,450000,5450000
Asman Rayhan,17000000,6,0.035,595000,3570000,20570000
Cawisadi Hutasoit,14000000,3,0.025,350000,1050000,15050000
Rahman Abimanyu,5000000,3,0.03,150000,450000,5450000
Kamidin Supriyanto,6000000,6,0.015,90000,540000,6540000
Harja Suwarno,16000000,3,0.025,400000,1200000,17200000
Rika Agustina,18000000,3,0.025,450000,1350000,19350000
Darimin Salahudin,11000000,3,0.02,220000,660000,11660000
Hasta Haryanto,6000000,3,0.015,90000,270000,6270000
Hasim Simanjuntak,16000000,12,0.02,320000,3840000,19840000
Padma Hariyah,6000000,6,0.025,150000,900000,6900000
Jarwadi Anggriawan,18000000,6,0.015,270000,1620000,19620000
Asman Handoko,12000000,12,0.03,360000,4320000,16320000
Dadi Fabian,19000000,3,0.02,380000,1140000,20140000
Nasim Wicaksono,14000000,3,0.025,350000,1050000,15050000
Paramita Mandasari,5000000,3,0.02,100000,300000,5300000
Hardi Hutagalung,12000000,3,0.03,360000,1080000,13080000
Najam Satria,12000000,3,0.02,240000,720000,12720000
Okto Natsir,16000000,6,0.03,480000,2880000,18880000
Candrakanta Firmansyah,14000000,6,0.025,350000,2100000,16100000
Kamila Rahmawati,8000000,6,0.035,280000,1680000,9680000
Septi Andini,20000000,6,0.02,400000,2400000,22400000
Ina Ananda,8000000,6,0.015,120000,720000,8720000
Tari Namaga,5000000,6,0.03,150000,900000,5900000
Yusuf Sinaga,14000000,6,0.035,490000,2940000,16940000
Warji Marbun,20000000,12,0.035,700000,8400000,28400000
Joko Yudhistira,9000000,6,0.025,225000,1350000,10350000
Azalea Hassanah,20000000,3,0.035,700000,2100000,22100000
Carla Fernanda,20000000,3,0.025,500000,1500000,21500000
Vania Puspita,5000000,6,0.015,75000,450000,5450000
Hesti Prastuti,18000000,3,0.025,450000,1350000,19350000
Rudi Sihombing,10000000,6,0.035,350000,2100000,12100000
Asirwanda Waluyo,17000000,6,0.02,340000,2040000,19040000
Hafshah Amanta,20000000,6,0.02,400000,2400000,22400000
Erik Darmawan,17000000,6,0.025,425000,2550000,19550000
Banara Hakim,16000000,6,0.02,320000,1920000,17920000
Yono Setiawan,8000000,6,0.025,200000,1200000,9200000
Gatra Siregar,18000000,3,0.035,630000,1890000,19890000
Samsul Prasasta,16000000,6,0.02,320000,1920000,17920000
Rizki Satria,10000000,6,0.025,250000,1500000,11500000
Chandra Syahreza,14000000,3,0.015,210000,630000,14630000
Limar Purwadi,8000000,12,0.035,280000,3360000,11360000
Dipa Suwarno,16000000,6,0.035,560000,3360000,19360000
Dewi Fujiati,18000000,6,0.025,450000,2700000,20700000
Harimurti Natsir,7000000,3,0.035,245000,735000,7735000
Lukman Pradana,7000000,3,0.02,140000,420000,7420000
Upik Gunarto,19000000,6,0.03,570000,3420000,22420000
Linda Kuswandari,12000000,3,0.015,180000,540000,12540000
Teddy Haikal,19000000,6,0.025,475000,2850000,21850000
Mursita Haryanto,11000000,6,0.025,275000,1650000,12650000
Mitra Putra,5000000,6,0.02,100000,600000,5600000
Mulyono Kurniawan,9000000,6,0.025,225000,1350000,10350000
Yunita Amanta,20000000,3,0.035,700000,2100000,22100000
Jumari Januar,16000000,6,0.035,560000,3360000,19360000
Kemal Setiawan,11000000,12,0.025,275000,3300000,14300000
Cahyono Tampubolon,5000000,12,0.015,75000,900000,5900000
Salimah Saputri,10000000,12,0.03,300000,3600000,13600000
Radika Permadi,9000000,12,0.025,225000,2700000,11700000
Maida Andini,12000000,3,0.02,240000,720000,12720000
Legawa Halim,17000000,12,0.025,425000,5100000,22100000
Raditya Kuswoyo,18000000,3,0.025,450000,1350000,19350000
Mustofa Gunarto,14000000,6,0.025,350000,2100000,16100000
Jais Simbolon,18000000,6,0.025,450000,2700000,20700000
Warsita Mandala,12000000,3,0.025,300000,900000,12900000
Ditya Amanta,17000000,12,0.02,340000,4080000,21080000
Ilyas Wicaksono,19000000,3,0.025,475000,1425000,20425000
Mulyanto Utama,19000000,3,0.015,285000,855000,19855000
Aslijan Halim,16000000,3,0.03,480000,1440000,17440000
Nova Fujiati,11000000,3,0.02,220000,660000,11660000
Paris Aryani,9000000,12,0.02,180000,2160000,11160000
Maryanto Perdana,19000000,12,0.025,475000,5700000,24700000
Septi Putri,9000000,12,0.025,225000,2700000,11700000
Linda Utami,7000000,6,0.025,175000,1050000,8050000
Warta Wijaya,7000000,12,0.025,175000,2100000,9100000
Ika Saraswati,5000000,6,0.015,75000,450000,5450000
Jamil Sihombing,15000000,3,0.03,450000,1350000,16350000
Dimaz Ardana,16000000,6,0.025,400000,2400000,18400000
Salimah Purnawati,18000000,3,0.035,630000,1890000,19890000
Eman Airlangga,14000000,12,0.025,350000,4200000,18200000
Rahmawati Salma,19000000,12,0.025,475000,5700000,24700000
Tsabita Aryani,16000000,3,0.02,320000,960000,16960000
Karsana Salahudin,11000000,6,0.02,220000,1320000,12320000
Bakiman Gunarto,20000000,6,0.025,500000,3000000,23000000
Shakila Wijayanti,18000000,12,0.025,450000,5400000,23400000
Hari Hidayat,11000000,6,0.02,220000,1320000,12320000
Farah Saraswati,12000000,12,0.025,300000,3600000,15600000
Salimah Farida,14000000,6,0.035,490000,2940000,16940000
Dartono Saputra,17000000,6,0.015,255000,1530000,18530000
Wani Azizah,11000000,6,0.025,275000,1650000,12650000
Wardaya Pradana,12000000,6,0.025,300000,1800000,13800000
Ajimat Tampubolon,8000000,6,0.035,280000,1680000,9680000
Hasim Zulkarnain,10000000,12,0.03,300000,3600000,13600000
Vinsen Sudrajat,14000000,3,0.015,210000,630000,14630000
Balidin Utama,8000000,3,0.025,200000,600000,8600000
Galang Prayoga,7000000,6,0.035,245000,1470000,8470000
Nugraha Sihotang,17000000,3,0.035,595000,1785000,18785000
Mustofa Agustian,19000000,6,0.025,475000,2850000,21850000
Safina Melinda,8000000,6,0.025,200000,1200000,9200000
Timbul Pratama,15000000,3,0.015,225000,675000,15675000
Sartika Azzahra,15000000,12,0.035,525000,6300000,21300000
Nur Rachmawati,17000000,12,0.025,425000,5100000,22100000
Rahmawati Wulandari,18000000,6,0.035,630000,3780000,21780000
Ridwan Maulana,14000000,6,0.025,350000,2100000,16100000
Irwan Mustofa,18000000,12,0.02,360000,4320000,22320000
Cahyo Rahardian,20000000,3,0.025,500000,1500000,21500000
Okto Wicaksono,18000000,6,0.025,450000,2700000,20700000
Pandu Wasita,5000000,6,0.025,125000,750000,5750000
Hairyanto Prabowo,12000000,6,0.025,300000,1800000,13800000
Kuncara Nababan,16000000,12,0.02,320000,3840000,19840000
Darmana Faresta,10000000,6,0.035,350000,2100000,12100000
Ella Maheswari,14000000,12,0.025,350000,4200000,18200000
Utama Fabian,6000000,6,0.015,90000,540000,6540000
Agustina Hartati,15000000,3,0.02,300000,900000,15900000
Koko Maryadi,12000000,12,0.02,240000,2880000,14880000
Damu Hidayat,15000000,3,0.03,450000,1350000,16350000
Rusman Prakasa,7000000,3,0.025,175000,525000,7525000
Hendra Pratama,7000000,12,0.025,175000,2100000,9100000
Cemani Widodo,20000000,6,0.025,500000,3000000,23000000
Cayadi Satria,11000000,6,0.025,275000,1650000,12650000
Panji Widodo,10000000,12,0.025,250000,3000000,13000000
Niyaga Megantara,20000000,6,0.025,500000,3000000,23000000
Makuta Oktavian,14000000,6,0.03,420000,2520000,16520000
Sabri Maryadi,5000000,6,0.015,75000,450000,5450000
Kalim Himawan,10000000,6,0.03,300000,1800000,11800000
Tira Rahimah,7000000,3,0.02,140000,420000,7420000
Keisha Damayanti,11000000,6,0.02,220000,1320000,12320000
Rachel Afifah,18000000,6,0.025,450000,2700000,20700000
Daru Nainggolan,20000000,3,0.015,300000,900000,20900000
Kalim Lazuardi,8000000,12,0.02,160000,1920000,9920000
Rama Darmawan,5000000,3,0.02,100000,300000,5300000
Gaman Herlambang,8000000,6,0.03,240000,1440000,9440000
Lurhur Prakasa,17000000,12,0.02,340000,4080000,21080000
Kemal Pratama,7000000,6,0.035,245000,1470000,8470000
Karna Yanuar,7000000,3,0.025,175000,525000,7525000
Ratna Rahmawati,11000000,6,0.02,220000,1320000,12320000
Gandi Mansur,14000000,12,0.02,280000,3360000,17360000
Opung Wardana,10000000,6,0.02,200000,1200000,11200000
Kani Padmasari,15000000,12,0.035,525000,6300000,21300000
Mursita Rendra,10000000,6,0.035,350000,2100000,12100000
Pardi Maulana,7000000,6,0.025,175000,1050000,8050000
Mutia Aryanti,9000000,6,0.025,225000,1350000,10350000
Dacin Prasasta,19000000,12,0.015,285000,3420000,22420000
Asirwanda Widodo,8000000,3,0.02,160000,480000,8480000
Gandi Mangunsong,8000000,3,0.03,240000,720000,8720000
Adinata Simbolon,20000000,6,0.015,300000,1800000,21800000
Kawaca Hutapea,14000000,12,0.015,210000,2520000,16520000
Ifa Melinda,17000000,3,0.02,340000,1020000,18020000
Prima Febian,12000000,3,0.035,420000,1260000,13260000
Vania Utami,7000000,3,0.015,105000,315000,7315000
Vega Uwais,11000000,6,0.025,275000,1650000,12650000
Tasnim Damanik,17000000,12,0.025,425000,5100000,22100000
Harjo Wardana,8000000,12,0.025,200000,2400000,10400000
Damar Handoko,7000000,3,0.035,245000,735000,7735000
Vania Hasanah,9000000,6,0.015,135000,810000,9810000
Kawaya Sihombing,15000000,6,0.03,450000,2700000,17700000
Slamet Ahmad,14000000,3,0.015,210000,630000,14630000
Salwa Yulianti,7000000,3,0.025,175000,525000,7525000
Yunita Winarsih,9000000,6,0.035,315000,1890000,10890000
Jagapati Ahmad,9000000,6,0.015,135000,810000,9810000
Ina Puspasari,17000000,12,0.025,425000,5100000,22100000
Nrima Sabian,19000000,3,0.025,475000,1425000,20425000
Cindy Anjani,9000000,6,0.035,315000,1890000,10890000
Paiman Syahreza,8000000,6,0.02,160000,960000,8960000
Jarwa Wijaya,19000000,12,0.02,380000,4560000,23560000
Viman Handoko,18000000,6,0.035,630000,3780000,21780000
Limar Nugraha,18000000,3,0.02,360000,1080000,19080000
Hairyanto Putra,17000000,3,0.02,340000,1020000,18020000
Rafi Prakasa,7000000,6,0.03,210000,1260000,8260000
Eva Elvina,18000000,6,0.03,540000,3240000,21240000
Cahyanto Nababan,17000000,12,0.02,340000,4080000,21080000
Zelaya Agustina,9000000,6,0.025,225000,1350000,10350000
Ajimat Haryanto,7000000,6,0.025,175000,1050000,8050000
Shania Purwanti,7000000,6,0.035,245000,1470000,8470000
Respati Santoso,7000000,6,0.025,175000,1050000,8050000
Amelia Puspita,9000000,3,0.025,225000,675000,9675000
Caturangga Natsir,7000000,12,0.03,210000,2520000,9520000
Uchita Usamah,18000000,12,0.025,450000,5400000,23400000
Keisha Andini,6000000,12,0.02,120000,1440000,7440000
Catur Situmorang,19000000,6,0.02,380000,2280000,21280000
Kamaria Hassanah,17000000,12,0.02,340000,4080000,21080000
Ina Palastri,15000000,6,0.02,300000,1800000,16800000
Cakrabirawa Darojat,14000000,6,0.025,350000,2100000,16100000
Silvia Saputri,16000000,6,0.02,320000,1920000,17920000
Gading Ahmad,9000000,6,0.025,225000,1350000,10350000
Karsana Airlangga,8000000,6,0.035,280000,1680000,9680000
Kartika Halimah,17000000,6,0.025,425000,2550000,19550000
Gadang Arifin,18000000,6,0.02,360000,2160000,20160000
Zulfa Kusuma,7000000,6,0.03,210000,1260000,8260000
Puput Fujiati,10000000,3,0.025,250000,750000,10750000
Langgeng Purnawarman,15000000,6,0.03,450000,2700000,17700000
Sarah Aqila,11000000,6,0.025,275000,1650000,12650000
Luwar Ardianto,11000000,6,0.02,220000,1320000,12320000
Nyoman Siregar,10000000,3,0.03,300000,900000,10900000
Asmuni Dirgantara,17000000,3,0.03,510000,1530000,18530000
Dadap Manullang,8000000,12,0.02,160000,1920000,9920000
Mustofa Nugraha,9000000,6,0.025,225000,1350000,10350000
Ivan Hutasoit,11000000,3,0.025,275000,825000,11825000
Usman Abimanyu,19000000,3,0.025,475000,1425000,20425000
Ismail Sihombing,15000000,6,0.035,525000,3150000,18150000
Yessi Mardhiyah,10000000,6,0.025,250000,1500000,11500000
Kunthara Wijaya,18000000,6,0.025,450000,2700000,20700000
Nilam Novitasari,10000000,12,0.02,200000,2400000,12400000
Ganda Tamba,10000000,12,0.02,200000,2400000,12400000
Ikin Sinaga,18000000,6,0.025,450000,2700000,20700000
Tira Anandya,10000000,6,0.02,200000,1200000,11200000
Margana Abiputra,19000000,6,0.015,285000,1710000,20710000
Jindra Damanik,18000000,12,0.025,450000,5400000,23400000
Gamani Napitupulu,19000000,6,0.025,475000,2850000,21850000
Syahrini Anandya,5000000,3,0.015,75000,225000,5225000
Kayun Sitompul,9000000,6,0.025,225000,1350000,10350000
Ilyas Uwais,19000000,3,0.035,665000,1995000,20995000
Dimaz Sihombing,12000000,12,0.025,300000,3600000,15600000
Cemeti Darmawan,7000000,6,0.02,140000,840000,7840000
Dimas Adriansyah,14000000,3,0.015,210000,630000,14630000
Karna Alamsyah,5000000,3,0.015,75000,225000,5225000
Syahrini Hartati,9000000,3,0.02,180000,540000,9540000
Marsito Irawan,9000000,6,0.015,135000,810000,9810000
Paris Widiastuti,15000000,3,0.035,525000,1575000,16575000
Wisnu Jailani,20000000,6,0.02,400000,2400000,22400000
Ganesha Wijayanti,5000000,6,0.03,150000,900000,5900000
Cawisono Aswandi,14000000,12,0.035,490000,5880000,19880000
Himawan Prabowo,8000000,12,0.035,280000,3360000,11360000
Jati Situmorang,8000000,3,0.025,200000,600000,8600000
Gatra Abimanyu,9000000,6,0.02,180000,1080000,10080000
Limar Hidayanto,7000000,12,0.02,140000,1680000,8680000
Ratih Suartini,10000000,3,0.035,350000,1050000,11050000
Surya Hutapea,9000000,3,0.035,315000,945000,9945000
Bakti Rajata,16000000,3,0.035,560000,1680000,17680000
Emin Abiputra,20000000,6,0.025,500000,3000000,23000000
Yuliana Purnama,6000000,6,0.015,90000,540000,6540000
Danuja Sirait,15000000,6,0.025,375000,2250000,17250000
Praba Hutagalung,7000000,3,0.015,105000,315000,7315000
Gangsa Simbolon,7000000,6,0.025,175000,1050000,8050000
Lantar Thamrin,15000000,12,0.035,525000,6300000,21300000
Dadap Sihombing,14000000,6,0.025,350000,2100000,16100000
Tania Juwita,17000000,3,0.025,425000,1275000,18275000
Bagiya Perdana,11000000,6,0.015,165000,990000,11990000
Dwi Kahyang,9000000,6,0.025,225000,1350000,10350000
Ade Wijayanti,18000000,6,0.015,270000,1620000,19620000
Harimurti Damanik,7000000,12,0.025,175000,2100000,9100000
Waluyo Fabian,9000000,3,0.035,315000,945000,9945000
Restu Purnawati,20000000,12,0.035,700000,8400000,28400000
Cinta Andriani,9000000,6,0.02,180000,1080000,10080000
Maman Nugraha,14000000,6,0.035,490000,2940000,16940000
Cinthia Fathina,5000000,6,0.015,75000,450000,5450000
Gilang Prasetyo,19000000,6,0.025,475000,2850000,21850000
Cemani Lesmana,12000000,6,0.035,420000,2520000,14520000
Vero Supriyanto,20000000,6,0.02,400000,2400000,22400000
Edward Kusumo,20000000,6,0.035,700000,4200000,24200000
Rangga Sihotang,17000000,3,0.03,510000,1530000,18530000
Sintia Riyanti,7000000,3,0.025,175000,525000,7525000
Satya Situmorang,9000000,6,0.02,180000,1080000,10080000
Banara Hutagalung,14000000,12,0.035,490000,5880000,19880000
Galiono Wasita,9000000,6,0.035,315000,1890000,10890000
Dono Saefullah,11000000,6,0.035,385000,2310000,13310000
Dimaz Ardianto,20000000,6,0.015,300000,1800000,21800000
Kawaya Wardana,18000000,6,0.035,630000,3780000,21780000
Galih Damanik,16000000,3,0.025,400000,1200000,17200000
Ani Halimah,19000000,6,0.025,475000,2850000,21850000
Uchita Andini,20000000,6,0.02,400000,2400000,22400000
Bajragin Anggriawan,14000000,3,0.015,210000,630000,14630000
Amalia Wijayanti,17000000,3,0.025,425000,1275000,18275000
Bakiono Sihombing,14000000,6,0.035,490000,2940000,16940000
Eman Yudhistira,19000000,3,0.02,380000,1140000,20140000
Mursinin Sudrajat,16000000,6,0.025,400000,2400000,18400000
Karma Mansur,8000000,3,0.035,280000,840000,8840000
Raina Juwita,8000000,6,0.02,160000,960000,8960000
Martana Antoni,8000000,12,0.025,200000,2400000,10400000
Jagapati Rayhan,14000000,6,0.025,350000,2100000,16100000
Cecep Wijaya,18000000,12,0.015,270000,3240000,21240000
Novi Leilani,16000000,12,0.02,320000,3840000,19840000
Langgeng Abimanyu,19000000,6,0.025,475000,2850000,21850000
Kani Haryanti,7000000,3,0.02,140000,420000,7420000
Hartaka Lesmana,7000000,6,0.03,210000,1260000,8260000
Tsabita Usada,14000000,3,0.025,350000,1050000,15050000
Cakrabuana Hidayanto,15000000,3,0.03,450000,1350000,16350000
Galang Simbolon,14000000,3,0.025,350000,1050000,15050000
Febi Padmasari,5000000,3,0.035,175000,525000,5525000
Bakiman Darojat,19000000,6,0.015,285000,1710000,20710000
Mila Winarsih,8000000,6,0.015,120000,720000,8720000
Jinawi Hidayat,5000000,6,0.035,175000,1050000,6050000
Cecep Hutasoit,10000000,6,0.025,250000,1500000,11500000
Kambali Pangestu,16000000,6,0.025,400000,2400000,18400000
Amalia Kahyang,5000000,3,0.02,100000,300000,5300000
Restu Purwanti,7000000,6,0.02,140000,840000,7840000
Balapati Pranowo,11000000,3,0.025,275000,825000,11825000
Yoga Oktavian,15000000,6,0.015,225000,1350000,16350000
Raden Maulana,10000000,6,0.02,200000,1200000,11200000
Raisa Suartini,5000000,12,0.015,75000,900000,5900000
Victoria Salsabilla,16000000,3,0.015,240000,720000,16720000
Limar Tamba,10000000,6,0.025,250000,1500000,11500000
Galang Putra,14000000,6,0.03,420000,2520000,16520000
Laila Utami,16000000,12,0.025,400000,4800000,20800000
Nyoman Irfandi,15000000,12,0.02,300000,3600000,18600000
Kawaca Wijaya,8000000,6,0.035,280000,1680000,9680000
Ade Febrianti,8000000,12,0.03,240000,2880000,10880000
Karman Zulkarnain,10000000,3,0.025,250000,750000,10750000
Cinta Zahrah,19000000,6,0.015,285000,1710000,20710000
Malika Puspita,16000000,6,0.02,320000,1920000,17920000
Jumadi Habibi,8000000,3,0.015,120000,360000,8360000
Karta Supriyanto,17000000,12,0.035,595000,7140000,24140000
Taufik Rahardian,15000000,6,0.02,300000,1800000,16800000
Gamanto Wacana,20000000,6,0.03,600000,3600000,23600000
Tira Kusmawati,11000000,3,0.015,165000,495000,11495000
Cemani Irawan,20000000,6,0.015,300000,1800000,21800000
Darmana Hidayanto,20000000,6,0.02,400000,2400000,22400000
Dono Purnama,15000000,6,0.025,375000,2250000,17250000
Parman Herlambang,20000000,3,0.015,300000,900000,20900000
Usman Mansur,19000000,6,0.03,570000,3420000,22420000
Aditya Ardianto,17000000,12,0.025,425000,5100000,22100000
Sadina Mulyani,18000000,3,0.025,450000,1350000,19350000
Damar Mangunsong,16000000,6,0.025,400000,2400000,18400000
Yessi Maheswari,17000000,3,0.035,595000,1785000,18785000
Yahya Saragih,19000000,6,0.035,665000,3990000,22990000
Teddy Tampubolon,15000000,12,0.02,300000,3600000,18600000
Dartono Rayhan,18000000,12,0.02,360000,4320000,22320000
Sadina Astuti,14000000,12,0.025,350000,4200000,18200000
Nada Riyanti,15000000,6,0.025,375000,2250000,17250000
Galak Wardana,6000000,12,0.025,150000,1800000,7800000
Satya Haikal,17000000,3,0.015,255000,765000,17765000
Hendra Supriyanto,16000000,3,0.025,400000,1200000,17200000
Gading Marbun,16000000,3,0.02,320000,960000,16960000
Luwes Mahardika,14000000,6,0.025,350000,2100000,16100000
Balapati Napitupulu,17000000,6,0.025,425000,2550000,19550000
Raden Himawan,17000000,3,0.02,340000,1020000,18020000
Nasrullah Saputra,6000000,3,0.025,150000,450000,6450000
Ilsa Azzahra,8000000,6,0.015,120000,720000,8720000
Umay Suwarno,10000000,3,0.02,200000,600000,10600000
Teguh Himawan,18000000,12,0.025,450000,5400000,23400000
Silvia Astuti,18000000,6,0.025,450000,2700000,20700000
Kamal Gunawan,20000000,6,0.015,300000,1800000,21800000
Yahya Gunawan,19000000,6,0.025,475000,2850000,21850000
Lidya Hartati,11000000,12,0.035,385000,4620000,15620000
Gatra Satria,11000000,6,0.035,385000,2310000,13310000
Yulia Nathania,14000000,6,0.02,280000,1680000,15680000
Xanana Najmudin,20000000,6,0.015,300000,1800000,21800000
Luis Thamrin,20000000,3,0.025,500000,1500000,21500000
Makuta Wahyudin,18000000,3,0.025,450000,1350000,19350000
Banawi Natsir,16000000,12,0.025,400000,4800000,20800000
Gada Wijaya,17000000,12,0.035,595000,7140000,24140000
Najam Marbun,8000000,6,0.02,160000,960000,8960000
Radit Mangunsong,8000000,6,0.025,200000,1200000,9200000
Dyah Hariyah,12000000,6,0.025,300000,1800000,13800000
Ihsan Airlangga,17000000,3,0.025,425000,1275000,18275000
Mala Yuniar,15000000,6,0.035,525000,3150000,18150000
Makuta Haryanto,16000000,6,0.025,400000,2400000,18400000
Edi Sihombing,11000000,6,0.025,275000,1650000,12650000
Yoga Prayoga,11000000,6,0.025,275000,1650000,12650000
Bakijan Hakim,15000000,3,0.025,375000,1125000,16125000
Iriana Aurelia,16000000,6,0.03,480000,2880000,18880000
Endah Azzahra,5000000,6,0.025,125000,750000,5750000
Oman Agustian,14000000,3,0.035,490000,1470000,15470000
Cahya Rajasa,5000000,6,0.035,175000,1050000,6050000
Irsad Hakim,8000000,12,0.03,240000,2880000,10880000
Ani Usada,10000000,6,0.015,150000,900000,10900000
Nugraha Waskita,15000000,6,0.035,525000,3150000,18150000
Kenzie Tarihoran,18000000,6,0.015,270000,1620000,19620000
Gasti Agustina,14000000,3,0.025,350000,1050000,15050000
Vinsen Prayoga,5000000,6,0.025,125000,750000,5750000
Aurora Sudiati,20000000,12,0.015,300000,3600000,23600000
Bakiman Rendra,20000000,3,0.035,700000,2100000,22100000
Prasetya Budiyanto,12000000,3,0.025,300000,900000,12900000
Mustika Suryono,11000000,6,0.015,165000,990000,11990000
Septi Wulandari,20000000,12,0.035,700000,8400000,28400000
Eman Saputra,19000000,3,0.025,475000,1425000,20425000
Lantar Bagaskara,15000000,6,0.015,225000,1350000,16350000
Harjo Prayoga,15000000,6,0.025,375000,2250000,17250000
Slamet Hakim,16000000,6,0.02,320000,1920000,17920000
Nabila Wastuti,18000000,6,0.025,450000,2700000,20700000
Jaka Rendra,11000000,6,0.035,385000,2310000,13310000
Karman Wahyudin,9000000,3,0.025,225000,675000,9675000
Darmanto Prakasa,19000000,6,0.035,665000,3990000,22990000
Arta Situmorang,16000000,3,0.035,560000,1680000,17680000
Galak Dirgantara,18000000,3,0.035,630000,1890000,19890000
Queen Ananda,15000000,3,0.035,525000,1575000,16575000
Drajat Sihombing,20000000,6,0.035,700000,4200000,24200000
Dadi Winarno,12000000,3,0.035,420000,1260000,13260000
Laksita Fernanda,9000000,6,0.035,315000,1890000,10890000
Balijan Prakasa,7000000,6,0.035,245000,1470000,8470000
Setya Purnawarman,11000000,12,0.025,275000,3300000,14300000
Bahuwirya Ramadan,14000000,6,0.015,210000,1260000,15260000
Kariman Napitupulu,18000000,3,0.035,630000,1890000,19890000
Yosef Prabowo,16000000,3,0.02,320000,960000,16960000
Michelle Winarsih,7000000,6,0.02,140000,840000,7840000
Jagapati Supriyanto,5000000,6,0.03,150000,900000,5900000
Gangsa Pradana,15000000,6,0.02,300000,1800000,16800000
Uli Yulianti,10000000,6,0.035,350000,2100000,12100000
Langgeng Oktovian,15000000,6,0.035,525000,3150000,18150000
Ophelia Ardiyanti,10000000,6,0.02,200000,1200000,11200000
Artanto Putra,5000000,6,0.03,150000,900000,5900000
Raden Suryono,18000000,6,0.035,630000,3780000,21780000
Prayogo Prasetya,12000000,6,0.025,300000,1800000,13800000
Widya Laksmiwati,16000000,6,0.025,400000,2400000,18400000
Tiara Aqila,11000000,12,0.035,385000,4620000,15620000
Lega Wijaya,15000000,6,0.03,450000,2700000,17700000
Dwi Hermawan,8000000,3,0.02,160000,480000,8480000
Novi Wastuti,12000000,6,0.025,300000,1800000,13800000
Bella Prastuti,15000000,3,0.03,450000,1350000,16350000
Kamal Mustofa,18000000,3,0.015,270000,810000,18810000
Asman Purwadi,15000000,3,0.02,300000,900000,15900000
Gibran Tampubolon,14000000,3,0.035,490000,1470000,15470000
Vanya Zulaika,7000000,6,0.02,140000,840000,7840000
Gandewa Airlangga,17000000,6,0.02,340000,2040000,19040000
Nasim Firmansyah,18000000,6,0.02,360000,2160000,20160000
Vanesa Handayani,14000000,6,0.015,210000,1260000,15260000
Lanjar Himawan,14000000,6,0.02,280000,1680000,15680000
Umaya Pratama,15000000,12,0.03,450000,5400000,20400000
Nova Wastuti,19000000,6,0.025,475000,2850000,21850000
Aris Saptono,17000000,3,0.025,425000,1275000,18275000
Jumari Sinaga,20000000,6,0.025,500000,3000000,23000000
Rosalina Mayasari,12000000,6,0.025,300000,1800000,13800000
Jarwadi Aswandi,20000000,6,0.025,500000,3000000,23000000
Elon Sitompul,15000000,12,0.02,300000,3600000,18600000
Ihsan Rajata,8000000,3,0.025,200000,600000,8600000
Jagapati Airlangga,8000000,3,0.035,280000,840000,8840000
Uli Juwita,18000000,3,0.02,360000,1080000,19080000
Bagus Yanuar,14000000,6,0.015,210000,1260000,15260000
Wulan Hassanah,15000000,6,0.015,225000,1350000,16350000
Lala Aurelia,16000000,3,0.025,400000,1200000,17200000
Makara Pranowo,6000000,6,0.025,150000,900000,6900000
Lukman Najmudin,11000000,3,0.03,330000,990000,11990000
Arta Wacana,16000000,12,0.025,400000,4800000,20800000
Legawa Wicaksono,20000000,6,0.015,300000,1800000,21800000
Raditya Haryanto,11000000,6,0.03,330000,1980000,12980000
Rini Zahrah,9000000,6,0.025,225000,1350000,10350000
Rahmat Darojat,19000000,6,0.025,475000,2850000,21850000
Yuliana Namaga,7000000,6,0.015,105000,630000,7630000
Putri Riyanti,18000000,6,0.035,630000,3780000,21780000
Hesti Damayanti,17000000,12,0.025,425000,5100000,22100000
Vega Abimanyu,9000000,6,0.025,225000,1350000,10350000
Nrima Wijaya,7000000,3,0.035,245000,735000,7735000
Salsabila Oktaviani,9000000,12,0.025,225000,2700000,11700000
Hani Mardhiyah,18000000,3,0.025,450000,1350000,19350000
Tomi Jailani,7000000,12,0.025,175000,2100000,9100000
Luhung Hidayanto,6000000,6,0.025,150000,900000,6900000
Hasna Melinda,19000000,6,0.03,570000,3420000,22420000
Kasiyah Yuliarti,5000000,12,0.015,75000,900000,5900000
Hilda Salma,12000000,6,0.015,180000,1080000,13080000
Damu Natsir,17000000,6,0.02,340000,2040000,19040000
Lala Anggraini,19000000,12,0.02,380000,4560000,23560000
Puput Anandya,9000000,6,0.035,315000,1890000,10890000
Restu Nasyidah,5000000,3,0.035,175000,525000,5525000
Luthfi Rahardian,5000000,6,0.025,125000,750000,5750000
Ibun Purnama,16000000,12,0.03,480000,5760000,21760000
Adikara Prayoga,7000000,3,0.035,245000,735000,7735000
Warsita Darmawan,18000000,12,0.025,450000,5400000,23400000
Safira Aurelia,14000000,3,0.035,490000,1470000,15470000
Gadang Prayoga,19000000,12,0.035,665000,7980000,26980000
Hendri Oktavian,17000000,6,0.035,595000,3570000,20570000
Mustofa Lazuardi,15000000,6,0.035,525000,3150000,18150000
Vero Waluyo,10000000,12,0.025,250000,3000000,13000000
Gangsa Nainggolan,20000000,12,0.035,700000,8400000,28400000
Pardi Perdana,11000000,6,0.035,385000,2310000,13310000
Yunita Yuliarti,16000000,3,0.025,400000,1200000,17200000
Luhung Adriansyah,16000000,6,0.035,560000,3360000,19360000
Eman Suryono,14000000,6,0.02,280000,1680000,15680000
Septi Uyainah,17000000,3,0.03,510000,1530000,18530000
Ella Zulaika,11000000,12,0.025,275000,3300000,14300000
Harjo Mansur,15000000,12,0.02,300000,3600000,18600000
Panca Pradipta,10000000,3,0.03,300000,900000,10900000
Hilda Puspasari,7000000,12,0.025,175000,2100000,9100000
Jindra Lazuardi,12000000,12,0.02,240000,2880000,14880000
Paramita Zahrah,12000000,6,0.03,360000,2160000,14160000
Ibun Pradipta,7000000,3,0.025,175000,525000,7525000
Dewi Anjani,7000000,12,0.025,175000,2100000,9100000
Nrima Zulkarnain,16000000,6,0.02,320000,1920000,17920000
Faizah Nasyidah,7000000,12,0.03,210000,2520000,9520000
Natalia Febrianti,8000000,3,0.02,160000,480000,8480000
Najam Darojat,6000000,6,0.025,150000,900000,6900000
Empluk Wibowo,20000000,6,0.03,600000,3600000,23600000
Mulyono Winarno,11000000,6,0.015,165000,990000,11990000
Puspa Prastuti,7000000,6,0.025,175000,1050000,8050000
Balangga Herlambang,11000000,3,0.03,330000,990000,11990000
Tasdik Budiyanto,16000000,6,0.03,480000,2880000,18880000
Purwanto Salahudin,10000000,3,0.035,350000,1050000,11050000
Sidiq Prabowo,14000000,12,0.02,280000,3360000,17360000
Intan Leilani,19000000,6,0.025,475000,2850000,21850000
Balamantri Mandala,7000000,12,0.025,175000,2100000,9100000
Asmadi Jailani,8000000,6,0.035,280000,1680000,9680000
Karsana Narpati,12000000,12,0.025,300000,3600000,15600000
Harja Sabian,7000000,6,0.015,105000,630000,7630000
Darijan Gunawan,14000000,3,0.02,280000,840000,14840000
Zelaya Nurlaela,19000000,12,0.025,475000,5700000,24700000
Imam Dirgantara,8000000,3,0.035,280000,840000,8840000
Raden Ardana,14000000,12,0.025,350000,4200000,18200000
Rangga Jailani,17000000,12,0.035,595000,7140000,24140000
Ganep Oktovian,8000000,3,0.035,280000,840000,8840000
Ifa Laksita,20000000,6,0.025,500000,3000000,23000000
Vivi Hastuti,17000000,12,0.025,425000,5100000,22100000
Nilam Hassanah,18000000,6,0.02,360000,2160000,20160000
Rosa Puspita,18000000,6,0.025,450000,2700000,20700000
Agus Utama,7000000,3,0.035,245000,735000,7735000
Adikara Budiman,7000000,6,0.015,105000,630000,7630000
Hendra Firgantoro,12000000,12,0.035,420000,5040000,17040000
Caket Adhitama,6000000,3,0.025,150000,450000,6450000
Gaman Utama,8000000,3,0.025,200000,600000,8600000
Indra Arifin,8000000,6,0.025,200000,1200000,9200000
Saka Iswahyudi,8000000,12,0.015,120000,1440000,9440000
Adiarja Wicaksono,6000000,6,0.035,210000,1260000,7260000
Jais Pradana,8000000,6,0.025,200000,1200000,9200000
Jessica Zulaika,8000000,6,0.035,280000,1680000,9680000
Oni Pertiwi,9000000,3,0.025,225000,675000,9675000
Lanang Marpaung,11000000,3,0.025,275000,825000,11825000
Ganesha Yolanda,18000000,6,0.025,450000,2700000,20700000
Panji Setiawan,5000000,12,0.025,125000,1500000,6500000
Gading Narpati,7000000,12,0.035,245000,2940000,9940000
Cakrawangsa Nashiruddin,11000000,6,0.025,275000,1650000,12650000
Himawan Natsir,14000000,6,0.03,420000,2520000,16520000
Lili Padmasari,20000000,6,0.025,500000,3000000,23000000
Vanya Mulyani,15000000,3,0.025,375000,1125000,16125000
Kenari Hidayanto,8000000,6,0.02,160000,960000,8960000
Devi Maheswari,10000000,6,0.025,250000,1500000,11500000
Tasdik Yanuar,18000000,6,0.035,630000,3780000,21780000
Zelaya Yuniar,5000000,6,0.02,100000,600000,5600000
Laras Agustina,8000000,6,0.025,200000,1200000,9200000
Gamanto Herlambang,9000000,6,0.025,225000,1350000,10350000
Kairav Kusumo,11000000,3,0.015,165000,495000,11495000
Ibrani Wardana,17000000,6,0.035,595000,3570000,20570000
Febrina Rahayu,10000000,12,0.015,150000,1800000,11800000
Hafshah Kusmawati,12000000,3,0.025,300000,900000,12900000
Jasmin Novitasari,20000000,3,0.015,300000,900000,20900000
Bakiman Gunawan,14000000,3,0.02,280000,840000,14840000
Pranata Santoso,10000000,3,0.025,250000,750000,10750000
Endra Saputra,20000000,12,0.025,500000,6000000,26000000
Shania Mardhiyah,5000000,12,0.015,75000,900000,5900000
Citra Afifah,7000000,6,0.02,140000,840000,7840000
Leo Simanjuntak,20000000,3,0.025,500000,1500000,21500000
Gilang Nainggolan,19000000,6,0.025,475000,2850000,21850000
Kirana Azizah,14000000,12,0.02,280000,3360000,17360000
Anggun Azizah,18000000,3,0.02,360000,1080000,19080000
Emil Pratama,7000000,3,0.035,245000,735000,7735000
Balidin Rendra,14000000,12,0.03,420000,5040000,19040000
Balamantri Yudhistira,9000000,6,0.035,315000,1890000,10890000
Asmadi Darojat,15000000,6,0.035,525000,3150000,18150000
Tantri Namaga,14000000,12,0.025,350000,4200000,18200000
Rahmat Nanda,7000000,6,0.025,175000,1050000,8050000
Karman Adhitama,15000000,12,0.02,300000,3600000,18600000
Rina Usada,17000000,6,0.025,425000,2550000,19550000
Tari Mardhiyah,14000000,6,0.02,280000,1680000,15680000
Nadine Usada,10000000,6,0.025,250000,1500000,11500000
Gamblang Lesmana,7000000,12,0.02,140000,1680000,8680000
Yance Jelita,19000000,3,0.035,665000,1995000,20995000
Retno Laksita,5000000,6,0.02,100000,600000,5600000
Naura Novitasari,18000000,12,0.015,270000,3240000,21240000
Tami Puspita,18000000,6,0.035,630000,3780000,21780000
Puti Pertiwi,8000000,6,0.025,200000,1200000,9200000
Elvina Salma,19000000,3,0.02,380000,1140000,20140000
Bagiya Alamsyah,5000000,3,0.03,150000,450000,5450000
Sari Ananda,16000000,6,0.02,320000,1920000,17920000
Kamila Kusuma,10000000,3,0.015,150000,450000,10450000
Olivia Purnama,17000000,3,0.025,425000,1275000,18275000
Sidiq Prayoga,16000000,3,0.02,320000,960000,16960000
Lestari Nasyiah,11000000,3,0.02,220000,660000,11660000
Jindra Latupono,9000000,6,0.035,315000,1890000,10890000
Zaenab Mulyani,15000000,6,0.025,375000,2250000,17250000
Elon Perdana,9000000,6,0.03,270000,1620000,10620000
Cawuk Irfandi,7000000,6,0.035,245000,1470000,8470000
Vinsen Rayhan,14000000,12,0.025,350000,4200000,18200000
Warji Wibisono,9000000,12,0.015,135000,1620000,10620000
Imam Budiyanto,9000000,6,0.015,135000,810000,9810000
Zahra Yuniar,19000000,3,0.025,475000,1425000,20425000
Jelita Wahyuni,17000000,6,0.035,595000,3570000,20570000
Soleh Hidayanto,20000000,3,0.03,600000,1800000,21800000
Puti Hasanah,15000000,3,0.025,375000,1125000,16125000
Winda Usamah,20000000,12,0.035,700000,8400000,28400000
Dewi Yolanda,19000000,6,0.025,475000,2850000,21850000
Luis Irfandi,20000000,12,0.015,300000,3600000,23600000
Gasti Nasyiah,15000000,6,0.025,375000,2250000,17250000
Yani Puspita,9000000,12,0.02,180000,2160000,11160000
Anastasia Laksmiwati,14000000,12,0.025,350000,4200000,18200000
Puti Safitri,18000000,3,0.02,360000,1080000,19080000
Karen Agustina,18000000,12,0.015,270000,3240000,21240000
Gamblang Budiyanto,19000000,3,0.035,665000,1995000,20995000
Hartaka Agustian,15000000,6,0.02,300000,1800000,16800000
Liman Darmawan,12000000,6,0.025,300000,1800000,13800000
Harja Siregar,19000000,3,0.02,380000,1140000,20140000
Wulandari Anjani,11000000,3,0.015,165000,495000,11495000
Prabawa Widodo,7000000,12,0.025,175000,2100000,9100000
Limar Agustian,10000000,6,0.025,250000,1500000,11500000
Wirda Rahimah,11000000,3,0.035,385000,1155000,12155000
Limar Suwarno,9000000,3,0.025,225000,675000,9675000
Michelle Maharani,15000000,6,0.015,225000,1350000,16350000
Rosman Sihotang,16000000,6,0.025,400000,2400000,18400000
Indra Prasetyo,16000000,6,0.02,320000,1920000,17920000
Jindra Mansur,12000000,6,0.025,300000,1800000,13800000
Indah Wahyuni,5000000,6,0.025,125000,750000,5750000
Rafid Rayhan,20000000,12,0.025,500000,6000000,26000000
Vino Habibi,18000000,6,0.025,450000,2700000,20700000
Indah Ramadhani,9000000,6,0.035,315000,1890000,10890000
Ratna Kusmawati,8000000,6,0.025,200000,1200000,9200000
Bakiadi Abimanyu,12000000,12,0.025,300000,3600000,15600000
Hendra Salahudin,7000000,3,0.025,175000,525000,7525000
Langgeng Rendra,10000000,3,0.02,200000,600000,10600000
Gadis Azizah,10000000,6,0.025,250000,1500000,11500000
Kanda Damanik,19000000,3,0.025,475000,1425000,20425000
Banawi Arifin,11000000,3,0.025,275000,825000,11825000
Umaya Prakasa,20000000,6,0.02,400000,2400000,22400000
Gabriella Puspita,18000000,3,0.025,450000,1350000,19350000
Timbul Agustian,17000000,3,0.035,595000,1785000,18785000
Baktiadi Waluyo,19000000,6,0.035,665000,3990000,22990000
Siti Nurlaela,18000000,12,0.02,360000,4320000,22320000
Candrakanta Siregar,11000000,12,0.015,165000,1980000,12980000
Usyi Saraswati,17000000,6,0.02,340000,2040000,19040000
Nasab Wasita,16000000,6,0.03,480000,2880000,18880000
Sintia Maharani,12000000,6,0.02,240000,1440000,13440000
Narji Firmansyah,18000000,6,0.035,630000,3780000,21780000
Harimurti Saefullah,20000000,12,0.025,500000,6000000,26000000
Jaya Sihombing,7000000,6,0.02,140000,840000,7840000
Jagapati Agustian,15000000,3,0.025,375000,1125000,16125000
Cahyono Setiawan,12000000,3,0.025,300000,900000,12900000
Oman Mahendra,15000000,3,0.035,525000,1575000,16575000
Cakrawangsa Kurniawan,9000000,3,0.015,135000,405000,9405000
Emong Tarihoran,6000000,6,0.02,120000,720000,6720000
Bagiya Rajata,11000000,12,0.025,275000,3300000,14300000
Edi Wardana,17000000,6,0.03,510000,3060000,20060000
Dartono Sudrajat,11000000,3,0.02,220000,660000,11660000
Teguh Irawan,11000000,6,0.03,330000,1980000,12980000
Faizah Wulandari,11000000,6,0.025,275000,1650000,12650000
Maryanto Nashiruddin,15000000,12,0.035,525000,6300000,21300000
Zulaikha Nasyiah,8000000,6,0.025,200000,1200000,9200000
Hafshah Leilani,17000000,3,0.035,595000,1785000,18785000
Dagel Pangestu,20000000,6,0.025,500000,3000000,23000000
Bajragin Darmawan,10000000,3,0.015,150000,450000,10450000
Kartika Yolanda,14000000,12,0.02,280000,3360000,17360000
Umaya Iswahyudi,7000000,3,0.02,140000,420000,7420000
Koko Sitorus,20000000,3,0.025,500000,1500000,21500000
Yuni Kusmawati,20000000,6,0.035,700000,4200000,24200000
Uchita Kusuma,7000000,6,0.02,140000,840000,7840000
Lili Leilani,11000000,12,0.025,275000,3300000,14300000
Utama Purwadi,14000000,3,0.035,490000,1470000,15470000
Samsul Darojat,14000000,6,0.025,350000,2100000,16100000
Melani Fathina,12000000,6,0.03,360000,2160000,14160000
Daryani Rajasa,17000000,3,0.035,595000,1785000,18785000
Ivan Kurniawan,18000000,3,0.025,450000,1350000,19350000
Tantri Anjani,10000000,12,0.025,250000,3000000,13000000
Bakiono Jailani,5000000,3,0.025,125000,375000,5375000
Surya Saputra,20000000,3,0.025,500000,1500000,21500000
Elvina Handayani,6000000,12,0.015,90000,1080000,7080000
Yani Susanti,19000000,3,0.035,665000,1995000,20995000
Calista Saraswati,16000000,6,0.02,320000,1920000,17920000
Luwes Tamba,9000000,6,0.035,315000,1890000,10890000
Purwanto Saragih,14000000,6,0.015,210000,1260000,15260000
Joko Pradipta,20000000,12,0.025,500000,6000000,26000000
Jane Maheswari,18000000,12,0.035,630000,7560000,25560000
Nada Andriani,11000000,12,0.02,220000,2640000,13640000
Jaka Gunarto,11000000,3,0.035,385000,1155000,12155000
Novi Mardhiyah,10000000,3,0.03,300000,900000,10900000
Rahmi Ananda,8000000,12,0.025,200000,2400000,10400000
Padma Purnawati,5000000,6,0.035,175000,1050000,6050000
Ilyas Situmorang,16000000,3,0.025,400000,1200000,17200000
Darmana Prabowo,11000000,12,0.015,165000,1980000,12980000
Ian Sitompul,5000000,3,0.02,100000,300000,5300000
Pandu Pradana,8000000,12,0.025,200000,2400000,10400000
Lantar Waskita,7000000,12,0.02,140000,1680000,8680000
Nyana Sirait,18000000,6,0.02,360000,2160000,20160000
Wira Setiawan,11000000,12,0.025,275000,3300000,14300000
Mujur Suryono,5000000,3,0.035,175000,525000,5525000
Dalima Puspasari,10000000,3,0.015,150000,450000,10450000
Silvia Rachmawati,19000000,12,0.035,665000,7980000,26980000
Vanya Zahrah,15000000,3,0.015,225000,675000,15675000
Harsana Sirait,20000000,6,0.025,500000,3000000,23000000
Padma Mandasari,7000000,6,0.015,105000,630000,7630000
Karya Lazuardi,9000000,3,0.025,225000,675000,9675000
Nadia Kusmawati,8000000,12,0.015,120000,1440000,9440000
Amalia Permata,17000000,6,0.025,425000,2550000,19550000
Dwi Perdana,11000000,12,0.02,220000,2640000,13640000
Vicky Puspita,7000000,6,0.025,175000,1050000,8050000
Almira Febrianti,16000000,6,0.035,560000,3360000,19360000
Banara Napitupulu,20000000,3,0.035,700000,2100000,22100000
Jono Bagaskara,20000000,12,0.015,300000,3600000,23600000
Almira Maheswari,16000000,6,0.035,560000,3360000,19360000
Nilam Azzahra,18000000,6,0.025,450000,2700000,20700000
Janet Ramadhani,15000000,6,0.025,375000,2250000,17250000
Yance Kusmawati,9000000,6,0.015,135000,810000,9810000
Cakrawangsa Sinaga,7000000,12,0.035,245000,2940000,9940000
Yuliana Andini,14000000,3,0.025,350000,1050000,15050000
Gawati Haryanti,9000000,12,0.025,225000,2700000,11700000
Cinta Aryani,16000000,12,0.025,400000,4800000,20800000
Pardi Maulana,14000000,6,0.02,280000,1680000,15680000
Harjasa Habibi,8000000,3,0.025,200000,600000,8600000
Safira Aqila,8000000,3,0.025,200000,600000,8600000
Queen Mardhiyah,6000000,12,0.035,210000,2520000,8520000
Eja Ramadan,15000000,6,0.015,225000,1350000,16350000
Zizi Riyanti,11000000,6,0.03,330000,1980000,12980000
Eva Mayasari,19000000,3,0.015,285000,855000,19855000
Mulya Febian,20000000,6,0.02,400000,2400000,22400000
Farah Maharani,10000000,12,0.03,300000,3600000,13600000
Gambira Purnama,10000000,6,0.025,250000,1500000,11500000
Oskar Simanjuntak,8000000,3,0.025,200000,600000,8600000
Budi Santoso,11000000,12,0.025,275000,3300000,14300000
Ifa Prastuti,5000000,6,0.02,100000,600000,5600000
Padma Zahrah,12000000,6,0.035,420000,2520000,14520000
Kani Novitasari,10000000,12,0.025,250000,3000000,13000000
Cindy Anandya,16000000,12,0.025,400000,4800000,20800000
Kasiyah Anjani,12000000,12,0.035,420000,5040000,17040000
Lurhur Yulianto,12000000,12,0.025,300000,3600000,15600000
Lukita Prasetya,20000000,6,0.025,500000,3000000,23000000
Respati Supriyanto,7000000,12,0.015,105000,1260000,8260000
Garda Permadi,8000000,3,0.02,160000,480000,8480000
Asman Prasetya,10000000,3,0.025,250000,750000,10750000
Artawan Firgantoro,18000000,3,0.035,630000,1890000,19890000
Darmana Irawan,16000000,3,0.025,400000,1200000,17200000
Bella Aqila,16000000,12,0.035,560000,6720000,22720000
Rendy Suwarno,14000000,3,0.03,420000,1260000,15260000
Galih Hakim,18000000,3,0.025,450000,1350000,19350000
Daliman Mandala,9000000,12,0.03,270000,3240000,12240000
Balangga Setiawan,16000000,6,0.025,400000,2400000,18400000
Jasmin Laksmiwati,14000000,12,0.03,420000,5040000,19040000
Qori Kahyang,11000000,3,0.035,385000,1155000,12155000
Yoga Firmansyah,15000000,6,0.02,300000,1800000,16800000
Titin Pratiwi,15000000,3,0.02,300000,900000,15900000
Darimin Narpati,18000000,6,0.02,360000,2160000,20160000
Galang Ardana,17000000,3,0.03,510000,1530000,18530000
Warta Wicaksono,16000000,6,0.03,480000,2880000,18880000
Teguh Irfandi,10000000,6,0.03,300000,1800000,11800000
Adhiarja Narpati,5000000,6,0.025,125000,750000,5750000
Lutfan Rahardian,11000000,12,0.02,220000,2640000,13640000
Jaga Sitompul,19000000,6,0.025,475000,2850000,21850000
Pandu Pratama,8000000,3,0.025,200000,600000,8600000
Amalia Nasyiah,11000000,6,0.035,385000,2310000,13310000
Wani Novitasari,8000000,12,0.015,120000,1440000,9440000
Emil Nashiruddin,5000000,3,0.02,100000,300000,5300000
Ina Wulandari,9000000,12,0.025,225000,2700000,11700000
Garang Handoko,19000000,6,0.02,380000,2280000,21280000
Pardi Irawan,11000000,12,0.025,275000,3300000,14300000
Ibun Siregar,15000000,3,0.035,525000,1575000,16575000
Bancar Samosir,6000000,6,0.035,210000,1260000,7260000
Jaga Ahmad,9000000,6,0.025,225000,1350000,10350000
Vanya Halimah,5000000,3,0.03,150000,450000,5450000
Jaya Mahardika,9000000,3,0.025,225000,675000,9675000
Edi Salahudin,9000000,6,0.025,225000,1350000,10350000
Ajiono Haikal,18000000,3,0.035,630000,1890000,19890000
Eman Mahardika,17000000,6,0.025,425000,2550000,19550000
Jasmin Nathania,8000000,3,0.03,240000,720000,8720000
Vega Mandala,8000000,6,0.035,280000,1680000,9680000
Gina Winarsih,16000000,6,0.035,560000,3360000,19360000
Jumadi Wardana,12000000,3,0.025,300000,900000,12900000
Sartika Hasanah,15000000,12,0.02,300000,3600000,18600000
Cawisono Situmorang,11000000,3,0.035,385000,1155000,12155000
Ulya Damayanti,6000000,3,0.02,120000,360000,6360000
Cahyo Maulana,17000000,6,0.035,595000,3570000,20570000
Irsad Halim,12000000,6,0.015,180000,1080000,13080000
Cengkal Megantara,19000000,6,0.02,380000,2280000,21280000
Manah Lazuardi,12000000,3,0.02,240000,720000,12720000
Febriana Saraswati,19000000,3,0.015,285000,855000,19855000
Mahesa Nainggolan,7000000,6,0.035,245000,1470000,8470000
Hendra Prasetyo,12000000,3,0.02,240000,720000,12720000
Galiono Purnawarman,15000000,3,0.02,300000,900000,15900000
Karsana Gunarto,14000000,6,0.02,280000,1680000,15680000
Vero Gunawan,19000000,12,0.025,475000,5700000,24700000
Vania Kusmawati,17000000,3,0.025,425000,1275000,18275000
Aisyah Suartini,17000000,12,0.025,425000,5100000,22100000
Septi Fathina,15000000,6,0.025,375000,2250000,17250000
Ana Suryatmi,14000000,12,0.025,350000,4200000,18200000
Linda Haryanti,5000000,3,0.035,175000,525000,5525000
Rosalina Suryatmi,7000000,6,0.025,175000,1050000,8050000
Lili Rahimah,15000000,6,0.025,375000,2250000,17250000
Eli Juwita,16000000,3,0.02,320000,960000,16960000
Bella Novitasari,15000000,3,0.035,525000,1575000,16575000
Rosalina Hastuti,11000000,6,0.035,385000,2310000,13310000
Estiono Antoni,20000000,3,0.035,700000,2100000,22100000
Irsad Prasetyo,8000000,3,0.035,280000,840000,8840000
Latika Laksmiwati,8000000,3,0.03,240000,720000,8720000
Ajeng Palastri,10000000,3,0.025,250000,750000,10750000
Nur Azzahra,15000000,3,0.015,225000,675000,15675000
Banawi Ahmad,5000000,6,0.035,175000,1050000,6050000
Harimurti Sihotang,19000000,6,0.025,475000,2850000,21850000
Nasim Bagaskara,11000000,6,0.02,220000,1320000,12320000
Paramita Lailasari,10000000,6,0.025,250000,1500000,11500000
Rudi Mahardika,9000000,6,0.025,225000,1350000,10350000
Garan Hidayat,20000000,3,0.025,500000,1500000,21500000
Gaman Rayhan,8000000,6,0.025,200000,1200000,9200000
Makara Suwarno,17000000,3,0.025,425000,1275000,18275000
Titin Leilani,6000000,3,0.025,150000,450000,6450000
Limar Oktavian,7000000,6,0.025,175000,1050000,8050000
Amelia Suryatmi,16000000,6,0.025,400000,2400000,18400000
Noviana Rahayu,20000000,6,0.015,300000,1800000,21800000
Jumadi Oktavian,9000000,6,0.025,225000,1350000,10350000
Koko Sinaga,7000000,3,0.015,105000,315000,7315000
Purwanto Handoko,7000000,3,0.035,245000,735000,7735000
Hani Lestari,11000000,6,0.015,165000,990000,11990000
Dalima Zahrah,15000000,6,0.03,450000,2700000,17700000
Aisyah Juwita,14000000,3,0.02,280000,840000,14840000
Radika Dirgantara,17000000,12,0.03,510000,6120000,23120000
Lidya Mayasari,12000000,3,0.025,300000,900000,12900000
Gawati Salma,11000000,6,0.035,385000,2310000,13310000
Asmianto Setiawan,12000000,6,0.025,300000,1800000,13800000
Alika Utami,16000000,6,0.035,560000,3360000,19360000
Nasab Nugroho,7000000,12,0.025,175000,2100000,9100000
Lasmanto Iswahyudi,18000000,6,0.02,360000,2160000,20160000
Irawati Kahyang,20000000,3,0.035,700000,2100000,22100000
Bakda Saragih,19000000,6,0.035,665000,3990000,22990000
Naradi Dirgantara,6000000,6,0.035,210000,1260000,7260000
Najam Prasetyo,18000000,6,0.025,450000,2700000,20700000
Ozy Ardana,7000000,6,0.02,140000,840000,7840000
Karna Permadi,20000000,6,0.035,700000,4200000,24200000
Jaya Adhitama,16000000,3,0.025,400000,1200000,17200000
Garan Maulana,7000000,6,0.025,175000,1050000,8050000
Rahmi Nasyidah,16000000,3,0.025,400000,1200000,17200000
Harsanto Ardana,10000000,6,0.02,200000,1200000,11200000
Ega Budiyanto,20000000,3,0.03,600000,1800000,21800000
Estiawan Satria,8000000,6,0.025,200000,1200000,9200000
Ani Fujiati,5000000,6,0.025,125000,750000,5750000
Novita Rachmawati,5000000,3,0.02,100000,300000,5300000
Samsul Prasetya,7000000,12,0.025,175000,2100000,9100000
Dagel Ahmad,10000000,6,0.025,250000,1500000,11500000
Wardaya Wibowo,8000000,3,0.035,280000,840000,8840000
Taufik Wahyudin,7000000,12,0.025,175000,2100000,9100000
Alambana Nanda,15000000,6,0.035,525000,3150000,18150000
Bahuwarna Pranowo,16000000,6,0.03,480000,2880000,18880000
Banara Haryanto,16000000,3,0.02,320000,960000,16960000
Kunthara Firgantoro,11000000,3,0.025,275000,825000,11825000
Febrina Prastuti,16000000,3,0.025,400000,1200000,17200000
Irwan Adriansyah,17000000,6,0.025,425000,2550000,19550000
Paiman Kurniawan,16000000,3,0.025,400000,1200000,17200000
Cahyanto Prasasta,18000000,3,0.02,360000,1080000,19080000
Luthfi Febian,19000000,6,0.025,475000,2850000,21850000
Kasiran Megantara,19000000,12,0.035,665000,7980000,26980000
Ajeng Saraswati,19000000,12,0.025,475000,5700000,24700000
Citra Rachmawati,20000000,6,0.025,500000,3000000,23000000
Vega Gunawan,9000000,12,0.03,270000,3240000,12240000
Gantar Prakasa,15000000,3,0.02,300000,900000,15900000
Asirwanda Sihombing,15000000,12,0.02,300000,3600000,18600000
Erik Arifin,8000000,6,0.035,280000,1680000,9680000
Ibrani Hidayat,10000000,3,0.035,350000,1050000,11050000
Karna Herlambang,7000000,6,0.02,140000,840000,7840000
Emin Mustofa,14000000,12,0.015,210000,2520000,16520000
Warji Perdana,18000000,6,0.025,450000,2700000,20700000
Gasti Usamah,17000000,3,0.025,425000,1275000,18275000
Wahyu Perdana,14000000,12,0.025,350000,4200000,18200000
Cemplunk Fabian,19000000,6,0.035,665000,3990000,22990000
Ajimin Mahardika,12000000,3,0.025,300000,900000,12900000
Daliono Wasita,6000000,12,0.025,150000,1800000,7800000
Almira Lailasari,15000000,6,0.025,375000,2250000,17250000
Hilda Yulianti,12000000,3,0.03,360000,1080000,13080000
Gilda Yolanda,8000000,6,0.035,280000,1680000,9680000
Oskar Suwarno,12000000,3,0.035,420000,1260000,13260000
Irwan Hutagalung,18000000,12,0.025,450000,5400000,23400000
Raditya Tarihoran,19000000,3,0.025,475000,1425000,20425000
Banawa Nababan,6000000,6,0.03,180000,1080000,7080000
Lukita Syahreza,18000000,6,0.015,270000,1620000,19620000
Reksa Hidayat,16000000,6,0.03,480000,2880000,18880000
Edison Nashiruddin,9000000,3,0.035,315000,945000,9945000
Kemba Pranowo,10000000,6,0.015,150000,900000,10900000
Gandi Ahmad,7000000,6,0.015,105000,630000,7630000
Safira Novitasari,19000000,6,0.03,570000,3420000,22420000
Estiono Marbun,19000000,3,0.035,665000,1995000,20995000
Aris Wardana,16000000,3,0.025,400000,1200000,17200000
Eva Padmasari,11000000,3,0.025,275000,825000,11825000
Aditya Lazuardi,14000000,6,0.035,490000,2940000,16940000
Nimas Fujiati,7000000,12,0.03,210000,2520000,9520000
Halim Abiputra,17000000,6,0.025,425000,2550000,19550000
Candrakanta Oktavian,10000000,6,0.015,150000,900000,10900000
Taswir Haryanto,16000000,6,0.015,240000,1440000,17440000
Ega Purnawarman,5000000,12,0.015,75000,900000,5900000
Lestari Hassanah,9000000,3,0.025,225000,675000,9675000
Latif Tampubolon,12000000,6,0.02,240000,1440000,13440000
Oskar Gunawan,8000000,3,0.025,200000,600000,8600000
Darimin Mahendra,5000000,3,0.025,125000,375000,5375000
Rika Halimah,5000000,3,0.025,125000,375000,5375000
Ilsa Leilani,11000000,12,0.015,165000,1980000,12980000
Kania Laksmiwati,12000000,12,0.03,360000,4320000,16320000
Maman Purwadi,20000000,6,0.025,500000,3000000,23000000
Jono Saptono,19000000,3,0.025,475000,1425000,20425000
Jaya Bagaskara,10000000,6,0.025,250000,1500000,11500000
Jaya Siregar,9000000,12,0.025,225000,2700000,11700000
Emas Wibisono,20000000,6,0.02,400000,2400000,22400000
Vivi Kusmawati,7000000,6,0.025,175000,1050000,8050000
Latika Hartati,7000000,3,0.015,105000,315000,7315000
Dasa Uwais,12000000,3,0.03,360000,1080000,13080000
Cemeti Haikal,19000000,3,0.025,475000,1425000,20425000
Jayeng Kurniawan,14000000,6,0.025,350000,2100000,16100000
Galur Adhitama,9000000,6,0.015,135000,810000,9810000
Cakrawangsa Maryadi,18000000,6,0.035,630000,3780000,21780000
Danu Hidayanto,9000000,6,0.025,225000,1350000,10350000
Maya Wastuti,16000000,12,0.03,480000,5760000,21760000
Emas Uwais,9000000,12,0.015,135000,1620000,10620000
Jais Haikal,5000000,12,0.025,125000,1500000,6500000
Dimas Hermawan,16000000,3,0.015,240000,720000,16720000
Puspita Nathania,17000000,6,0.025,425000,2550000,19550000
Nasab Sabian,16000000,3,0.025,400000,1200000,17200000
Mahdi Pradipta,8000000,3,0.015,120000,360000,8360000
Hadi Budiyanto,11000000,6,0.03,330000,1980000,12980000
Gandewa Sitompul,9000000,6,0.025,225000,1350000,10350000
Mulyono Rajata,17000000,12,0.02,340000,4080000,21080000
Nrima Natsir,9000000,6,0.035,315000,1890000,10890000
Bala Marpaung,14000000,12,0.015,210000,2520000,16520000
Vanesa Prastuti,5000000,12,0.025,125000,1500000,6500000
Naradi Saragih,15000000,12,0.02,300000,3600000,18600000
Farhunnisa Halimah,10000000,6,0.035,350000,2100000,12100000
Najib Oktovian,17000000,6,0.025,425000,2550000,19550000
Kala Nababan,18000000,6,0.015,270000,1620000,19620000
Ana Yuliarti,17000000,3,0.025,425000,1275000,18275000
Virman Adhitama,5000000,6,0.025,125000,750000,5750000
Vicky Rahayu,18000000,6,0.025,450000,2700000,20700000
Rafi Ardianto,19000000,3,0.015,285000,855000,19855000
Rini Jelita,19000000,6,0.015,285000,1710000,20710000
Dagel Maryadi,8000000,3,0.015,120000,360000,8360000
Harjasa Fabian,20000000,12,0.035,700000,8400000,28400000
Putu Nababan,14000000,6,0.025,350000,2100000,16100000
Ajiono Herlambang,20000000,6,0.035,700000,4200000,24200000
Murti Irfandi,16000000,12,0.015,240000,2880000,18880000
Banara Ardana,12000000,12,0.015,180000,2160000,14160000
Caturangga Siregar,20000000,6,0.015,300000,1800000,21800000
Kasusra Santoso,15000000,12,0.02,300000,3600000,18600000
Hasna Riyanti,12000000,3,0.02,240000,720000,12720000
Makara Natsir,7000000,6,0.03,210000,1260000,8260000
Nasim Prasetya,14000000,6,0.03,420000,2520000,16520000
Zizi Aryani,20000000,3,0.02,400000,1200000,21200000
Lamar Syahreza,20000000,3,0.02,400000,1200000,21200000
Purwanto Winarno,17000000,6,0.025,425000,2550000,19550000
Zizi Saraswati,9000000,3,0.02,180000,540000,9540000
Gilang Suryono,7000000,6,0.025,175000,1050000,8050000
Sarah Melani,5000000,6,0.015,75000,450000,5450000
Tugiman Irfandi,7000000,6,0.025,175000,1050000,8050000
Malika Padmasari,12000000,12,0.025,300000,3600000,15600000
Ajimin Setiawan,18000000,3,0.025,450000,1350000,19350000
Safina Puspasari,17000000,6,0.025,425000,2550000,19550000
Mahmud Pradipta,12000000,6,0.025,300000,1800000,13800000
Jatmiko Adhitama,9000000,6,0.03,270000,1620000,10620000
Ade Damanik,10000000,6,0.02,200000,1200000,11200000
Nrima Nainggolan,17000000,3,0.025,425000,1275000,18275000
Bakiono Saputra,11000000,6,0.025,275000,1650000,12650000
Mila Aryanti,20000000,3,0.03,600000,1800000,21800000
Paramita Nurlaela,18000000,6,0.025,450000,2700000,20700000
Melinda Oktaviani,14000000,6,0.025,350000,2100000,16100000
Ikhsan Wardana,5000000,6,0.035,175000,1050000,6050000
Silvia Handayani,5000000,3,0.025,125000,375000,5375000
Eva Hastuti,8000000,6,0.03,240000,1440000,9440000
Fathonah Nuraini,10000000,3,0.015,150000,450000,10450000
Sherly Purwanti,15000000,6,0.02,300000,1800000,16800000
Sabar Maryadi,20000000,12,0.025,500000,6000000,26000000
Aslijan Perdana,12000000,6,0.025,300000,1800000,13800000
Kirana Permata,7000000,6,0.015,105000,630000,7630000
Cawisadi Irfandi,12000000,3,0.015,180000,540000,12540000
Darmana Bagaskara,10000000,3,0.025,250000,750000,10750000
Rudi Rayhan,7000000,3,0.015,105000,315000,7315000
Rahayu Mandasari,17000000,3,0.035,595000,1785000,18785000
Mulyono Ardana,8000000,6,0.02,160000,960000,8960000
Johan Pradipta,20000000,12,0.025,500000,6000000,26000000
Kenes Sudrajat,12000000,6,0.02,240000,1440000,13440000
Muhammad Abimanyu,8000000,6,0.025,200000,1200000,9200000
Jaka Antoni,5000000,6,0.035,175000,1050000,6050000
Rita Zulaika,20000000,6,0.03,600000,3600000,23600000
Bahuwirya Hutapea,16000000,3,0.035,560000,1680000,17680000
Devi Ningrum,19000000,3,0.025,475000,1425000,20425000
Kardi Sitorus,14000000,6,0.035,490000,2940000,16940000
Viktor Prabowo,16000000,6,0.035,560000,3360000,19360000
Irfan Firgantoro,7000000,6,0.035,245000,1470000,8470000
Rahmat Irfandi,11000000,6,0.025,275000,1650000,12650000
Jabal Wibowo,12000000,12,0.025,300000,3600000,15600000
Amelia Pertiwi,18000000,6,0.03,540000,3240000,21240000
Titin Saraswati,16000000,6,0.025,400000,2400000,18400000
Malika Laksmiwati,14000000,12,0.025,350000,4200000,18200000
Mursita Supriyanto,15000000,3,0.025,375000,1125000,16125000
Cornelia Hassanah,18000000,3,0.025,450000,1350000,19350000
Murti Purnawarman,16000000,3,0.02,320000,960000,16960000
Empluk Rayhan,11000000,6,0.015,165000,990000,11990000
Ivan Purnama,18000000,3,0.025,450000,1350000,19350000
Latika Maryati,20000000,3,0.035,700000,2100000,22100000
Adikara Mustofa,16000000,3,0.025,400000,1200000,17200000
Dalimin Hidayat,9000000,3,0.02,180000,540000,9540000
Fitriani Nathania,15000000,12,0.03,450000,5400000,20400000
Ganda Lesmana,19000000,6,0.025,475000,2850000,21850000
Laila Rachmawati,15000000,6,0.025,375000,2250000,17250000
Hendra Latupono,20000000,3,0.035,700000,2100000,22100000
Heryanto Manullang,7000000,3,0.025,175000,525000,7525000
Darijan Yanuar,10000000,12,0.02,200000,2400000,12400000
Mustika Winarno,5000000,6,0.025,125000,750000,5750000
Akarsana Pratama,7000000,3,0.02,140000,420000,7420000
Rahayu Afifah,9000000,6,0.025,225000,1350000,10350000
Garan Budiyanto,11000000,12,0.025,275000,3300000,14300000
Anastasia Aurelia,11000000,6,0.015,165000,990000,11990000
Nardi Adhitama,7000000,6,0.015,105000,630000,7630000
Balidin Oktavian,16000000,12,0.035,560000,6720000,22720000
Kalim Lesmana,17000000,6,0.025,425000,2550000,19550000
Eva Rahimah,12000000,6,0.015,180000,1080000,13080000
Puspita Andriani,11000000,6,0.025,275000,1650000,12650000
Hari Permadi,19000000,6,0.035,665000,3990000,22990000
Bakiman Yanuar,16000000,3,0.02,320000,960000,16960000
Elon Nainggolan,20000000,12,0.025,500000,6000000,26000000
Dimaz Samosir,15000000,6,0.035,525000,3150000,18150000
Ifa Kuswandari,8000000,3,0.015,120000,360000,8360000
Reksa Putra,18000000,6,0.035,630000,3780000,21780000
Sintia Leilani,10000000,12,0.035,350000,4200000,14200000
Lukita Pradana,9000000,6,0.02,180000,1080000,10080000
Sabrina Mulyani,20000000,6,0.02,400000,2400000,22400000
Mariadi Winarno,10000000,3,0.02,200000,600000,10600000
Balidin Pradana,14000000,6,0.025,350000,2100000,16100000
Kurnia Hardiansyah,15000000,12,0.03,450000,5400000,20400000
Uchita Pudjiastuti,11000000,6,0.02,220000,1320000,12320000
Edison Setiawan,10000000,6,0.025,250000,1500000,11500000
Edison Wardana,18000000,12,0.015,270000,3240000,21240000
Sherly Saputri,8000000,6,0.025,200000,1200000,9200000
Purwanto Suryono,9000000,6,0.015,135000,810000,9810000
Yani Harini,17000000,6,0.02,340000,2040000,19040000
Damu Faresta,17000000,12,0.02,340000,4080000,21080000
Jagapati Widodo,8000000,3,0.025,200000,600000,8600000
Linda Mulyani,8000000,6,0.035,280000,1680000,9680000
Ganda Prasetya,20000000,3,0.025,500000,1500000,21500000
Maman Wibisono,14000000,12,0.025,350000,4200000,18200000
Yulia Laksmiwati,15000000,3,0.025,375000,1125000,16125000
Surya Dirgantara,19000000,3,0.015,285000,855000,19855000
Icha Mardhiyah,9000000,12,0.025,225000,2700000,11700000
Danuja Widodo,5000000,12,0.02,100000,1200000,6200000
Olivia Usamah,19000000,6,0.035,665000,3990000,22990000
Raharja Budiman,11000000,12,0.025,275000,3300000,14300000
Rahayu Aurelia,20000000,3,0.03,600000,1800000,21800000
Ikhsan Hutapea,8000000,3,0.035,280000,840000,8840000
Limar Winarno,14000000,3,0.035,490000,1470000,15470000
Uda Irfandi,17000000,3,0.02,340000,1020000,18020000
Uchita Andini,18000000,6,0.02,360000,2160000,20160000
Tri Ningrum,9000000,3,0.025,225000,675000,9675000
Jasmin Puspita,10000000,6,0.015,150000,900000,10900000
Okta Rendra,20000000,12,0.02,400000,4800000,24800000
Rachel Wijayanti,18000000,12,0.035,630000,7560000,25560000
Karimah Yulianti,8000000,12,0.02,160000,1920000,9920000
Novi Anandya,9000000,6,0.02,180000,1080000,10080000
Pardi Hutapea,18000000,12,0.035,630000,7560000,25560000
Pangeran Sitompul,14000000,6,0.02,280000,1680000,15680000
Kawaya Mansur,17000000,3,0.025,425000,1275000,18275000
Dagel Haikal,15000000,3,0.03,450000,1350000,16350000
Siska Nathania,15000000,6,0.02,300000,1800000,16800000
Alika Fujiati,14000000,3,0.035,490000,1470000,15470000
Salimah Puspasari,11000000,3,0.03,330000,990000,11990000
Warsita Nugraha,19000000,12,0.02,380000,4560000,23560000
Tania Rahimah,12000000,6,0.02,240000,1440000,13440000
Karna Halim,16000000,6,0.025,400000,2400000,18400000
Caturangga Jailani,8000000,3,0.025,200000,600000,8600000
Limar Simbolon,11000000,6,0.035,385000,2310000,13310000
Ghaliyati Winarsih,14000000,6,0.02,280000,1680000,15680000
Hani Widiastuti,14000000,12,0.02,280000,3360000,17360000
Taufan Widodo,6000000,6,0.015,90000,540000,6540000
Salman Lazuardi,8000000,12,0.025,200000,2400000,10400000
Najib Syahreza,9000000,6,0.025,225000,1350000,10350000
Malika Novitasari,10000000,3,0.035,350000,1050000,11050000
Aslijan Nugraha,9000000,6,0.035,315000,1890000,10890000
Salman Bagaskara,11000000,12,0.025,275000,3300000,14300000
Gilang Anggriawan,16000000,3,0.02,320000,960000,16960000
Naura Anandya,9000000,12,0.035,315000,3780000,12780000
Wulandari Fernanda,17000000,6,0.015,255000,1530000,18530000
Hadi Yudhistira,8000000,12,0.025,200000,2400000,10400000
Hasta Prasetya,12000000,3,0.025,300000,900000,12900000
Chandra Kusumo,5000000,3,0.02,100000,300000,5300000
Pranata Abimanyu,5000000,6,0.03,150000,900000,5900000
Margana Habibi,7000000,6,0.035,245000,1470000,8470000
Emin Utama,8000000,6,0.03,240000,1440000,9440000
Hari Satria,17000000,3,0.025,425000,1275000,18275000
Lintang Rahayu,9000000,6,0.02,180000,1080000,10080000
Ghaliyati Afifah,7000000,12,0.015,105000,1260000,8260000
Najwa Aryanti,11000000,3,0.03,330000,990000,11990000
Wadi Iswahyudi,12000000,6,0.025,300000,1800000,13800000
Jatmiko Ardana,9000000,3,0.02,180000,540000,9540000
Dacin Prasetya,10000000,12,0.02,200000,2400000,12400000
Atmaja Sitompul,12000000,3,0.03,360000,1080000,13080000
Taswir Mahendra,18000000,3,0.035,630000,1890000,19890000
Baktianto Sitompul,9000000,6,0.02,180000,1080000,10080000
Salimah Azzahra,12000000,6,0.035,420000,2520000,14520000
Mulyanto Lazuardi,14000000,6,0.025,350000,2100000,16100000
Ilyas Samosir,16000000,6,0.025,400000,2400000,18400000
Alika Hartati,17000000,6,0.015,255000,1530000,18530000
Kadir Damanik,12000000,12,0.025,300000,3600000,15600000
Adika Sihombing,16000000,3,0.015,240000,720000,16720000
Hani Salma,14000000,6,0.03,420000,2520000,16520000
Jane Ramadhani,11000000,12,0.025,275000,3300000,14300000
Jaiman Megantara,19000000,3,0.025,475000,1425000,20425000
Nyana Hutasoit,8000000,12,0.02,160000,1920000,9920000
Parman Saefullah,11000000,6,0.02,220000,1320000,12320000
Ciaobella Yuniar,17000000,6,0.02,340000,2040000,19040000
Sabar Prasasta,19000000,6,0.015,285000,1710000,20710000
Febriana Wahyuni,9000000,6,0.035,315000,1890000,10890000
Cici Putri,17000000,12,0.03,510000,6120000,23120000
Cahyanto Wicaksono,16000000,12,0.015,240000,2880000,18880000
Marsudi Saptono,9000000,6,0.025,225000,1350000,10350000
Nabila Maheswari,12000000,3,0.025,300000,900000,12900000
Cinthia Pudjiastuti,16000000,6,0.025,400000,2400000,18400000
Victoria Juwita,19000000,12,0.02,380000,4560000,23560000
Tari Nasyidah,8000000,3,0.025,200000,600000,8600000
Puspita Purnawati,7000000,3,0.03,210000,630000,7630000
Agnes Febrianti,8000000,3,0.03,240000,720000,8720000
Lestari Haryanti,11000000,3,0.02,220000,660000,11660000
Gamblang Rajasa,18000000,3,0.025,450000,1350000,19350000
Niyaga Maryadi,5000000,3,0.02,100000,300000,5300000
Purwadi Hutasoit,20000000,3,0.015,300000,900000,20900000
Setya Januar,9000000,3,0.02,180000,540000,9540000
Bakiman Manullang,19000000,3,0.03,570000,1710000,20710000
Samsul Thamrin,12000000,6,0.02,240000,1440000,13440000
Paramita Saraswati,16000000,6,0.025,400000,2400000,18400000
Prayoga Siregar,15000000,6,0.025,375000,2250000,17250000
Ayu Novitasari,12000000,12,0.025,300000,3600000,15600000
Rachel Hasanah,8000000,12,0.025,200000,2400000,10400000
Reksa Thamrin,14000000,3,0.02,280000,840000,14840000
Rendy Wibowo,18000000,6,0.015,270000,1620000,19620000
Dimaz Hermawan,9000000,3,0.025,225000,675000,9675000
Dodo Satria,18000000,12,0.025,450000,5400000,23400000
Balidin Nainggolan,14000000,6,0.03,420000,2520000,16520000
Kayun Natsir,10000000,3,0.035,350000,1050000,11050000
Irnanto Fabian,18000000,6,0.025,450000,2700000,20700000
Oman Handoko,16000000,6,0.02,320000,1920000,17920000
Cornelia Laksita,9000000,12,0.025,225000,2700000,11700000
Gandi Pratama,18000000,6,0.02,360000,2160000,20160000
Jefri Marbun,19000000,3,0.025,475000,1425000,20425000
Erik Lesmana,14000000,6,0.03,420000,2520000,16520000
Manah Hidayat,7000000,12,0.035,245000,2940000,9940000
Among Winarno,20000000,6,0.035,700000,4200000,24200000
Kunthara Saefullah,18000000,3,0.035,630000,1890000,19890000
Mulyono Oktavian,19000000,12,0.02,380000,4560000,23560000
Atmaja Prayoga,15000000,12,0.035,525000,6300000,21300000
Labuh Wicaksono,15000000,6,0.035,525000,3150000,18150000
Diana Salsabilla,16000000,6,0.03,480000,2880000,18880000
Ajiono Sihombing,10000000,12,0.02,200000,2400000,12400000
Nadine Puspita,20000000,3,0.03,600000,1800000,21800000
Naradi Saputra,10000000,3,0.025,250000,750000,10750000
Zulfa Palastri,16000000,3,0.025,400000,1200000,17200000
Yulia Wijayanti,14000000,6,0.025,350000,2100000,16100000
Jabal Mangunsong,11000000,3,0.015,165000,495000,11495000
Sakti Oktovian,15000000,12,0.015,225000,2700000,17700000
Ditya Leilani,11000000,3,0.025,275000,825000,11825000
Samsul Sitorus,15000000,12,0.02,300000,3600000,18600000
Gadis Puspita,8000000,6,0.03,240000,1440000,9440000
Winda Farida,7000000,6,0.015,105000,630000,7630000
Asmadi Yudhistira,19000000,6,0.025,475000,2850000,21850000
Sidiq Ardianto,6000000,3,0.025,150000,450000,6450000
Nugraha Prasasta,17000000,6,0.025,425000,2550000,19550000
Anita Mulyani,7000000,6,0.015,105000,630000,7630000
Yosef Firmansyah,6000000,3,0.015,90000,270000,6270000
Vino Hutasoit,12000000,3,0.02,240000,720000,12720000
Nyana Wacana,19000000,3,0.025,475000,1425000,20425000
Jane Palastri,19000000,3,0.02,380000,1140000,20140000
Laswi Wicaksono,5000000,12,0.015,75000,900000,5900000
Kairav Gunawan,9000000,12,0.025,225000,2700000,11700000
Laksita Ramadhani,5000000,6,0.025,125000,750000,5750000
Jaswadi Tampubolon,19000000,6,0.025,475000,2850000,21850000
Emong Kusumo,8000000,12,0.035,280000,3360000,11360000
Warta Yulianto,7000000,3,0.02,140000,420000,7420000
Sari Elvina,8000000,12,0.025,200000,2400000,10400000
Harimurti Damanik,15000000,6,0.035,525000,3150000,18150000
Eka Wicaksono,10000000,6,0.025,250000,1500000,11500000
Zulfa Saputri,6000000,3,0.025,150000,450000,6450000
Capa Narpati,16000000,6,0.025,400000,2400000,18400000
Banawa Suwarno,7000000,6,0.035,245000,1470000,8470000
Dodo Iswahyudi,17000000,12,0.025,425000,5100000,22100000
Jarwa Anggriawan,15000000,3,0.015,225000,675000,15675000
Dimas Prayoga,20000000,6,0.02,400000,2400000,22400000
Kenzie Darmawan,19000000,6,0.025,475000,2850000,21850000
Leo Firgantoro,12000000,6,0.035,420000,2520000,14520000
Bagus Thamrin,18000000,6,0.025,450000,2700000,20700000
Mulyono Hutasoit,10000000,6,0.03,300000,1800000,11800000
Mutia Handayani,8000000,6,0.025,200000,1200000,9200000
Kasusra Yanuar,16000000,12,0.025,400000,4800000,20800000
Anom Purnawarman,5000000,6,0.035,175000,1050000,6050000
Nur Usada,10000000,6,0.025,250000,1500000,11500000
Endah Lestari,10000000,3,0.025,250000,750000,10750000
Indra Iswahyudi,19000000,6,0.02,380000,2280000,21280000
Galur Prayoga,5000000,3,0.035,175000,525000,5525000
Ami Rahimah,11000000,3,0.025,275000,825000,11825000
Bakti Sudrajat,16000000,6,0.035,560000,3360000,19360000
Edi Purnama,14000000,6,0.015,210000,1260000,15260000
Rafid Nainggolan,14000000,12,0.035,490000,5880000,19880000
Imam Haikal,19000000,12,0.015,285000,3420000,22420000
Nasrullah Sirait,7000000,3,0.02,140000,420000,7420000
Estiawan Perdana,18000000,6,0.025,450000,2700000,20700000
Respati Najmudin,5000000,6,0.025,125000,750000,5750000
Harsanto Lesmana,14000000,6,0.02,280000,1680000,15680000
Mumpuni Saputra,15000000,6,0.03,450000,2700000,17700000
Ghani Mahardika,11000000,6,0.025,275000,1650000,12650000
Bakijan Nainggolan,10000000,3,0.025,250000,750000,10750000
Gandi Salahudin,11000000,6,0.035,385000,2310000,13310000
Jaga Sitompul,12000000,6,0.035,420000,2520000,14520000
Maman Hidayat,10000000,3,0.02,200000,600000,10600000
Ira Widiastuti,18000000,3,0.025,450000,1350000,19350000
Kusuma Salahudin,8000000,12,0.025,200000,2400000,10400000
Jagaraga Firgantoro,18000000,3,0.03,540000,1620000,19620000
Halim Situmorang,9000000,3,0.035,315000,945000,9945000
Abyasa Prasetyo,19000000,3,0.02,380000,1140000,20140000
Naura Nuraini,11000000,6,0.015,165000,990000,11990000
Naura Mustika,15000000,12,0.015,225000,2700000,17700000
Timbul Irfandi,7000000,3,0.025,175000,525000,7525000
Mila Purwanti,11000000,3,0.02,220000,660000,11660000
Upik Widodo,7000000,6,0.02,140000,840000,7840000
Saiful Faresta,12000000,6,0.025,300000,1800000,13800000
Juli Riyanti,17000000,12,0.015,255000,3060000,20060000
Drajat Ardana,8000000,3,0.025,200000,600000,8600000
Dasa Saefullah,11000000,6,0.03,330000,1980000,12980000
Halim Zulkarnain,10000000,6,0.025,250000,1500000,11500000
Bahuwirya Ardana,7000000,3,0.02,140000,420000,7420000
Gara Darmawan,9000000,3,0.035,315000,945000,9945000
Radika Purnama,16000000,3,0.025,400000,1200000,17200000
Fathonah Maharani,16000000,6,0.015,240000,1440000,17440000
Sartika Purwanti,17000000,6,0.025,425000,2550000,19550000
Setya Agustian,20000000,6,0.03,600000,3600000,23600000
Almira Hasanah,5000000,6,0.025,125000,750000,5750000
Bella Nasyiah,14000000,12,0.025,350000,4200000,18200000
Adinata Natsir,9000000,6,0.025,225000,1350000,10350000
Ulva Pertiwi,16000000,3,0.035,560000,1680000,17680000
Dasa Santoso,17000000,6,0.025,425000,2550000,19550000
Setya Waluyo,14000000,12,0.025,350000,4200000,18200000
Akarsana Nugroho,6000000,3,0.015,90000,270000,6270000
Cemeti Jailani,15000000,12,0.025,375000,4500000,19500000
Jane Laksita,11000000,6,0.03,330000,1980000,12980000
Safina Maheswari,16000000,12,0.02,320000,3840000,19840000
Kirana Kusuma,12000000,12,0.025,300000,3600000,15600000
Janet Sudiati,16000000,6,0.015,240000,1440000,17440000
Janet Maharani,19000000,6,0.02,380000,2280000,21280000
Kasiyah Sudiati,11000000,6,0.035,385000,2310000,13310000
Dadap Haikal,10000000,6,0.025,250000,1500000,11500000
Wardi Natsir,17000000,3,0.015,255000,765000,17765000
Yessi Rachmawati,10000000,12,0.035,350000,4200000,14200000
Dagel Wibowo,6000000,3,0.025,150000,450000,6450000
Harjaya Haryanto,10000000,12,0.03,300000,3600000,13600000
Kamal Sirait,9000000,3,0.025,225000,675000,9675000
Dagel Gunarto,16000000,6,0.025,400000,2400000,18400000
Ratih Yolanda,12000000,6,0.03,360000,2160000,14160000
Embuh Budiman,7000000,12,0.02,140000,1680000,8680000
Marsito Wacana,7000000,12,0.025,175000,2100000,9100000
Hari Maryadi,5000000,3,0.035,175000,525000,5525000
Aulia Saraswati,16000000,6,0.035,560000,3360000,19360000
Gara Putra,7000000,12,0.025,175000,2100000,9100000
Mala Mandasari,9000000,12,0.025,225000,2700000,11700000
Edi Nugraha,18000000,6,0.025,450000,2700000,20700000
Eko Herlambang,5000000,6,0.025,125000,750000,5750000
Genta Namaga,10000000,6,0.015,150000,900000,10900000
Kamidin Maheswara,12000000,6,0.03,360000,2160000,14160000
Cindy Yolanda,5000000,6,0.025,125000,750000,5750000
Marsito Supriyanto,19000000,3,0.015,285000,855000,19855000
Irawati Sudiati,17000000,6,0.015,255000,1530000,18530000
Balapati Darojat,19000000,3,0.035,665000,1995000,20995000
Cecep Purnama,20000000,12,0.025,500000,6000000,26000000
Najam Uwais,19000000,6,0.035,665000,3990000,22990000
Hendri Marbun,16000000,6,0.025,400000,2400000,18400000
Ria Azzahra,11000000,3,0.025,275000,825000,11825000
Aurora Farida,18000000,3,0.03,540000,1620000,19620000
Cawisono Rayhan,14000000,12,0.025,350000,4200000,18200000
Bakda Waskita,16000000,6,0.03,480000,2880000,18880000
Indra Pranowo,14000000,12,0.025,350000,4200000,18200000
Kariman Haikal,19000000,6,0.025,475000,2850000,21850000
Mila Damayanti,17000000,12,0.03,510000,6120000,23120000
Alika Mustika,14000000,6,0.02,280000,1680000,15680000
Jail Wibowo,16000000,6,0.035,560000,3360000,19360000
Indra Firmansyah,17000000,3,0.025,425000,1275000,18275000
Nada Maharani,16000000,6,0.02,320000,1920000,17920000
Mulya Tampubolon,11000000,3,0.015,165000,495000,11495000
Kenari Uwais,20000000,3,0.025,500000,1500000,21500000
Maras Haryanto,10000000,6,0.035,350000,2100000,12100000
Raihan Marpaung,14000000,6,0.015,210000,1260000,15260000
Fathonah Azizah,11000000,12,0.02,220000,2640000,13640000
Raisa Puspita,20000000,6,0.03,600000,3600000,23600000
Raditya Ardana,19000000,3,0.035,665000,1995000,20995000
Simon Putra,10000000,3,0.035,350000,1050000,11050000
Cayadi Agustian,9000000,6,0.025,225000,1350000,10350000
Wahyu Natsir,9000000,12,0.035,315000,3780000,12780000
Luluh Santoso,14000000,12,0.025,350000,4200000,18200000
Almira Yolanda,18000000,3,0.035,630000,1890000,19890000
Yance Afifah,18000000,12,0.02,360000,4320000,22320000
Jindra Saputra,9000000,6,0.025,225000,1350000,10350000
Raina Usamah,14000000,6,0.035,490000,2940000,16940000
Darman Mangunsong,18000000,3,0.015,270000,810000,18810000
Raharja Anggriawan,19000000,3,0.035,665000,1995000,20995000
Dwi Maryadi,12000000,6,0.025,300000,1800000,13800000
Hardana Prasasta,11000000,3,0.025,275000,825000,11825000
Empluk Maheswara,14000000,6,0.03,420000,2520000,16520000
Jamil Antoni,20000000,3,0.025,500000,1500000,21500000
Dwi Natsir,5000000,3,0.025,125000,375000,5375000
Balamantri Saputra,19000000,3,0.035,665000,1995000,20995000
Garda Marpaung,5000000,3,0.02,100000,300000,5300000
Makuta Hidayanto,19000000,6,0.02,380000,2280000,21280000
Aurora Melani,16000000,6,0.035,560000,3360000,19360000
Pangestu Prakasa,19000000,12,0.02,380000,4560000,23560000
Manah Manullang,9000000,6,0.015,135000,810000,9810000
Cawisono Febian,9000000,3,0.025,225000,675000,9675000
Ghaliyati Fathina,10000000,3,0.025,250000,750000,10750000
Utama Antoni,16000000,6,0.015,240000,1440000,17440000
Warji Sitompul,18000000,6,0.02,360000,2160000,20160000
Ridwan Perdana,15000000,12,0.025,375000,4500000,19500000
Mumpuni Aswandi,18000000,12,0.03,540000,6480000,24480000
Jaya Sabian,8000000,3,0.025,200000,600000,8600000
Tari Zulaika,6000000,6,0.025,150000,900000,6900000
Puput Mardhiyah,12000000,12,0.025,300000,3600000,15600000
Prayogo Nugraha,8000000,12,0.03,240000,2880000,10880000
Uli Harini,20000000,6,0.035,700000,4200000,24200000
Kani Hassanah,9000000,6,0.025,225000,1350000,10350000
Bambang Pangestu,15000000,12,0.025,375000,4500000,19500000
Perkasa Wasita,11000000,12,0.03,330000,3960000,14960000
Irnanto Hakim,20000000,6,0.025,500000,3000000,23000000
Jumari Wibisono,17000000,3,0.015,255000,765000,17765000
Elvina Aqila,16000000,6,0.025,400000,2400000,18400000
Tri Suwarno,17000000,3,0.025,425000,1275000,18275000
Zizi Saputri,14000000,3,0.025,350000,1050000,15050000
Utama Alamsyah,8000000,12,0.035,280000,3360000,11360000
Eluh Irfandi,10000000,6,0.025,250000,1500000,11500000
Jumari Rajata,14000000,3,0.035,490000,1470000,15470000
Asmadi Fabian,19000000,3,0.025,475000,1425000,20425000
Mustofa Alamsyah,8000000,6,0.035,280000,1680000,9680000
Enteng Sinaga,14000000,6,0.02,280000,1680000,15680000
Pranata Arifin,9000000,3,0.02,180000,540000,9540000
Adika Prasetyo,16000000,3,0.035,560000,1680000,17680000
Sabar Manullang,12000000,3,0.015,180000,540000,12540000
Novi Safitri,11000000,3,0.025,275000,825000,11825000
Rahmi Lestari,10000000,6,0.025,250000,1500000,11500000
Akarsana Pradipta,10000000,3,0.02,200000,600000,10600000
Kawaca Situmorang,17000000,6,0.025,425000,2550000,19550000
Balamantri Pradipta,17000000,12,0.025,425000,5100000,22100000
Kamila Aqila,14000000,6,0.025,350000,2100000,16100000
Unjani Utami,16000000,6,0.02,320000,1920000,17920000
Naura Lailasari,12000000,6,0.03,360000,2160000,14160000
Purwa Purwadi,6000000,6,0.015,90000,540000,6540000
Natalia Uyainah,11000000,3,0.03,330000,990000,11990000
Raden Hermawan,18000000,12,0.025,450000,5400000,23400000
Mutia Wahyuni,15000000,6,0.015,225000,1350000,16350000
Gaduh Maheswara,19000000,6,0.015,285000,1710000,20710000
Bakianto Nababan,9000000,6,0.02,180000,1080000,10080000
Kamila Handayani,7000000,3,0.015,105000,315000,7315000
Linda Permata,19000000,12,0.025,475000,5700000,24700000
Cahyono Winarno,17000000,12,0.035,595000,7140000,24140000
Heru Irfandi,14000000,6,0.025,350000,2100000,16100000
Betania Yulianti,20000000,3,0.02,400000,1200000,21200000
Febrina Anandya,20000000,6,0.035,700000,4200000,24200000
Aulia Agustina,12000000,6,0.015,180000,1080000,13080000
Prabowo Hidayanto,11000000,6,0.03,330000,1980000,12980000
Ridwan Yudhistira,20000000,3,0.03,600000,1800000,21800000
Edison Napitupulu,15000000,6,0.03,450000,2700000,17700000
Balijan Gunawan,11000000,3,0.025,275000,825000,11825000
Ganep Nashiruddin,5000000,12,0.025,125000,1500000,6500000
Cinta Yulianti,10000000,3,0.035,350000,1050000,11050000
Agus Kurniawan,14000000,3,0.025,350000,1050000,15050000
Ganesha Lailasari,9000000,6,0.03,270000,1620000,10620000
Mitra Mansur,16000000,3,0.035,560000,1680000,17680000
Balangga Kuswoyo,7000000,6,0.035,245000,1470000,8470000
Irsad Nugroho,9000000,6,0.025,225000,1350000,10350000
Cahyo Purnawarman,7000000,3,0.03,210000,630000,7630000
Kuncara Megantara,9000000,12,0.025,225000,2700000,11700000
Latif Lazuardi,5000000,3,0.025,125000,375000,5375000
Mahdi Salahudin,11000000,6,0.035,385000,2310000,13310000
Gaman Gunawan,12000000,3,0.025,300000,900000,12900000
Faizah Mayasari,18000000,12,0.015,270000,3240000,21240000
Hana Yuniar,5000000,6,0.025,125000,750000,5750000
Rahmat Oktavian,12000000,3,0.025,300000,900000,12900000
Hardi Marbun,17000000,3,0.02,340000,1020000,18020000
Rosa Zahrah,6000000,6,0.025,150000,900000,6900000
Narji Hidayanto,18000000,6,0.03,540000,3240000,21240000
Garang Siregar,18000000,3,0.025,450000,1350000,19350000
Lestari Saraswati,18000000,3,0.025,450000,1350000,19350000
Kenzie Simbolon,16000000,6,0.02,320000,1920000,17920000
Rika Hastuti,12000000,12,0.025,300000,3600000,15600000
Hani Rahmawati,9000000,12,0.025,225000,2700000,11700000
Lutfan Narpati,16000000,6,0.015,240000,1440000,17440000
Halim Mansur,11000000,12,0.025,275000,3300000,14300000
Pandu Wahyudin,14000000,12,0.025,350000,4200000,18200000
Sabri Mahardika,17000000,3,0.035,595000,1785000,18785000
Ilsa Nurlaela,19000000,3,0.025,475000,1425000,20425000
Aswani Widodo,10000000,6,0.025,250000,1500000,11500000
Niyaga Hutasoit,19000000,3,0.035,665000,1995000,20995000
Irfan Setiawan,9000000,6,0.025,225000,1350000,10350000
Maras Sinaga,11000000,6,0.02,220000,1320000,12320000
Kadir Fabian,12000000,3,0.025,300000,900000,12900000
Umar Bagaskara,17000000,6,0.035,595000,3570000,20570000
Kajen Rajata,11000000,12,0.03,330000,3960000,14960000
Kartika Melinda,10000000,3,0.02,200000,600000,10600000
Teddy Narpati,16000000,6,0.015,240000,1440000,17440000
Irawati Handayani,18000000,3,0.025,450000,1350000,19350000
Ozy Alamsyah,6000000,6,0.02,120000,720000,6720000
Daniswara Sitompul,14000000,12,0.035,490000,5880000,19880000
Daliman Aswandi,17000000,3,0.025,425000,1275000,18275000
Pratiwi Ningrum,17000000,12,0.02,340000,4080000,21080000
Najam Wicaksono,19000000,12,0.035,665000,7980000,26980000
Darimin Hutasoit,9000000,6,0.025,225000,1350000,10350000
Kairav Nugroho,12000000,6,0.015,180000,1080000,13080000
Wakiman Napitupulu,5000000,12,0.02,100000,1200000,6200000
Hasta Lesmana,17000000,12,0.025,425000,5100000,22100000
Unggul Ardana,16000000,6,0.035,560000,3360000,19360000
Zulfa Juwita,16000000,3,0.025,400000,1200000,17200000
Imam Wibisono,11000000,6,0.035,385000,2310000,13310000
Dirja Megantara,8000000,3,0.035,280000,840000,8840000
Azalea Ningrum,6000000,3,0.02,120000,360000,6360000
Bahuraksa Haikal,14000000,3,0.035,490000,1470000,15470000
Yahya Rajata,20000000,6,0.015,300000,1800000,21800000
Bagas Yudhistira,10000000,3,0.02,200000,600000,10600000
Kani Harini,10000000,12,0.02,200000,2400000,12400000
Anom Budiyanto,15000000,6,0.025,375000,2250000,17250000
Ibrani Maryadi,20000000,3,0.02,400000,1200000,21200000
Rosa Mardhiyah,12000000,6,0.025,300000,1800000,13800000
Nalar Mansur,11000000,3,0.02,220000,660000,11660000
Melinda Farida,14000000,12,0.025,350000,4200000,18200000
Luis Haikal,19000000,6,0.015,285000,1710000,20710000
Usyi Rahimah,12000000,6,0.025,300000,1800000,13800000
Dwi Anggraini,14000000,3,0.025,350000,1050000,15050000
Omar Prasasta,11000000,6,0.035,385000,2310000,13310000
Opung Simanjuntak,8000000,6,0.02,160000,960000,8960000
Kasim Adhitama,11000000,6,0.035,385000,2310000,13310000
Humaira Wastuti,17000000,3,0.025,425000,1275000,18275000
Taufik Rajasa,16000000,12,0.035,560000,6720000,22720000
Gangsar Utama,15000000,6,0.035,525000,3150000,18150000
Cengkir Mustofa,7000000,6,0.025,175000,1050000,8050000
Jaya Suryono,9000000,12,0.025,225000,2700000,11700000
Raden Wicaksono,19000000,6,0.02,380000,2280000,21280000
Prita Halimah,10000000,6,0.035,350000,2100000,12100000
Reksa Perdana,9000000,3,0.035,315000,945000,9945000
Kezia Azzahra,5000000,3,0.025,125000,375000,5375000
Candrakanta Mandala,5000000,6,0.02,100000,600000,5600000
Jaiman Supriyanto,16000000,6,0.02,320000,1920000,17920000
Putri Elvina,20000000,3,0.035,700000,2100000,22100000
Jabal Habibi,5000000,12,0.015,75000,900000,5900000
Dono Dirgantara,10000000,6,0.025,250000,1500000,11500000
Mulyono Wicaksono,18000000,12,0.035,630000,7560000,25560000
Farhunnisa Purnama,10000000,6,0.025,250000,1500000,11500000
Wirda Anggraini,15000000,3,0.025,375000,1125000,16125000
Pratiwi Lestari,17000000,3,0.035,595000,1785000,18785000
Lanang Hardiansyah,9000000,6,0.025,225000,1350000,10350000
Tomi Hardiansyah,14000000,6,0.015,210000,1260000,15260000
Ikhsan Fabian,16000000,12,0.025,400000,4800000,20800000
Anita Melinda,20000000,3,0.03,600000,1800000,21800000
Mulyono Yulianto,17000000,3,0.02,340000,1020000,18020000
Fitriani Nurlaela,8000000,6,0.02,160000,960000,8960000
Surya Suryono,14000000,6,0.025,350000,2100000,16100000
Vanesa Aryani,8000000,6,0.035,280000,1680000,9680000
Rizki Waluyo,11000000,12,0.03,330000,3960000,14960000
Surya Habibi,14000000,3,0.025,350000,1050000,15050000
Niyaga Mangunsong,17000000,6,0.03,510000,3060000,20060000
Gatot Utama,7000000,3,0.03,210000,630000,7630000
Enteng Sitorus,10000000,3,0.035,350000,1050000,11050000
Nadia Nasyiah,7000000,12,0.035,245000,2940000,9940000
Restu Namaga,18000000,3,0.03,540000,1620000,19620000
Asmianto Mangunsong,15000000,12,0.035,525000,6300000,21300000
Harja Prayoga,12000000,6,0.015,180000,1080000,13080000
Titin Usada,8000000,12,0.025,200000,2400000,10400000
Jabal Rajata,15000000,6,0.02,300000,1800000,16800000
Novi Halimah,16000000,6,0.035,560000,3360000,19360000
Tania Mardhiyah,8000000,3,0.035,280000,840000,8840000
Galur Anggriawan,17000000,6,0.025,425000,2550000,19550000
Zamira Prastuti,6000000,6,0.025,150000,900000,6900000
Anggabaya Saputra,14000000,6,0.03,420000,2520000,16520000
Danuja Hermawan,12000000,6,0.015,180000,1080000,13080000
Mahmud Iswahyudi,7000000,3,0.015,105000,315000,7315000
Karta Mangunsong,18000000,12,0.02,360000,4320000,22320000
Karma Saragih,18000000,6,0.035,630000,3780000,21780000
Ayu Wulandari,14000000,6,0.015,210000,1260000,15260000
Perkasa Budiyanto,19000000,12,0.025,475000,5700000,24700000
Darmaji Yudhistira,15000000,3,0.025,375000,1125000,16125000
Dariati Utama,17000000,3,0.035,595000,1785000,18785000
Julia Hartati,10000000,3,0.035,350000,1050000,11050000
Zulfa Ramadhani,10000000,6,0.035,350000,2100000,12100000
Raihan Saefullah,10000000,6,0.02,200000,1200000,11200000
Digdaya Aswandi,18000000,3,0.035,630000,1890000,19890000
Ibrahim Ahmad,17000000,3,0.025,425000,1275000,18275000
Gilang Adriansyah,10000000,6,0.015,150000,900000,10900000
Warsa Wacana,17000000,6,0.025,425000,2550000,19550000
Purwa Pradipta,16000000,3,0.02,320000,960000,16960000
Gilda Azzahra,16000000,3,0.025,400000,1200000,17200000
Gawati Leilani,15000000,6,0.02,300000,1800000,16800000
Febi Putri,11000000,6,0.025,275000,1650000,12650000
Carla Nasyidah,12000000,6,0.015,180000,1080000,13080000
Prasetya Napitupulu,10000000,6,0.035,350000,2100000,12100000
Farhunnisa Andini,9000000,3,0.025,225000,675000,9675000
Nova Wastuti,14000000,6,0.035,490000,2940000,16940000
Ivan Anggriawan,14000000,6,0.015,210000,1260000,15260000
Wakiman Hutagalung,20000000,6,0.035,700000,4200000,24200000
Maida Yulianti,15000000,6,0.02,300000,1800000,16800000
Tedi Narpati,6000000,12,0.025,150000,1800000,7800000
Jindra Febian,8000000,3,0.025,200000,600000,8600000
Aswani Perdana,18000000,12,0.02,360000,4320000,22320000
Lestari Aurelia,17000000,6,0.035,595000,3570000,20570000
Galar Nugraha,17000000,12,0.02,340000,4080000,21080000
Kajen Simanjuntak,7000000,3,0.02,140000,420000,7420000
Ikhsan Sitorus,19000000,6,0.02,380000,2280000,21280000
Prasetya Marpaung,11000000,3,0.035,385000,1155000,12155000
Virman Mansur,15000000,6,0.025,375000,2250000,17250000
Martani Lesmana,12000000,3,0.02,240000,720000,12720000
Cahyadi Zulkarnain,11000000,12,0.035,385000,4620000,15620000
Kenzie Prayoga,20000000,6,0.02,400000,2400000,22400000
Dyah Utami,20000000,3,0.03,600000,1800000,21800000
Embuh Wardana,9000000,6,0.035,315000,1890000,10890000
Cinthia Azizah,20000000,12,0.02,400000,4800000,24800000
Keisha Palastri,5000000,12,0.035,175000,2100000,7100000
Prayitna Budiyanto,9000000,12,0.025,225000,2700000,11700000
Latif Satria,5000000,3,0.035,175000,525000,5525000
Asirwanda Adhitama,15000000,3,0.025,375000,1125000,16125000
Panca Antoni,18000000,6,0.015,270000,1620000,19620000
Hasan Nashiruddin,7000000,3,0.02,140000,420000,7420000
Galang Tamba,16000000,12,0.03,480000,5760000,21760000
Balijan Satria,17000000,12,0.025,425000,5100000,22100000
Aslijan Prasetya,18000000,6,0.025,450000,2700000,20700000
Legawa Supriyanto,12000000,12,0.025,300000,3600000,15600000
Estiono Wicaksono,12000000,6,0.025,300000,1800000,13800000
Jefri Habibi,18000000,12,0.025,450000,5400000,23400000
Cakrabuana Prabowo,7000000,12,0.015,105000,1260000,8260000
Sakti Purnawarman,8000000,3,0.015,120000,360000,8360000
Mila Nurdiyanti,20000000,3,0.02,400000,1200000,21200000
Parman Prabowo,19000000,12,0.025,475000,5700000,24700000
Laksana Prasetya,20000000,3,0.035,700000,2100000,22100000
Lulut Oktovian,17000000,12,0.015,255000,3060000,20060000
Gangsa Salahudin,11000000,12,0.025,275000,3300000,14300000
Restu Rahayu,17000000,3,0.015,255000,765000,17765000
Amalia Andini,5000000,3,0.035,175000,525000,5525000
Labuh Natsir,7000000,6,0.02,140000,840000,7840000
Martani Dirgantara,7000000,6,0.03,210000,1260000,8260000
Bakidin Mahardika,9000000,3,0.035,315000,945000,9945000
Pranata Sudrajat,9000000,6,0.02,180000,1080000,10080000
Jatmiko Hermawan,9000000,3,0.02,180000,540000,9540000
Umar Tarihoran,17000000,12,0.03,510000,6120000,23120000
Ida Aryani,16000000,3,0.02,320000,960000,16960000
Caraka Syahreza,11000000,6,0.035,385000,2310000,13310000
Unjani Melinda,19000000,6,0.03,570000,3420000,22420000
Malika Andini,7000000,3,0.025,175000,525000,7525000
Jinawi Rahardian,11000000,3,0.02,220000,660000,11660000
Natalia Prastuti,19000000,3,0.035,665000,1995000,20995000
Jarwa Suryono,7000000,6,0.025,175000,1050000,8050000
Atma Pangestu,7000000,6,0.035,245000,1470000,8470000
Estiono Lazuardi,10000000,3,0.015,150000,450000,10450000
Teddy Mahardika,10000000,3,0.035,350000,1050000,11050000
Irnanto Perdana,9000000,3,0.015,135000,405000,9405000
Baktiono Ardana,19000000,12,0.025,475000,5700000,24700000
Elvin Purnama,12000000,6,0.025,300000,1800000,13800000
Kenzie Antoni,9000000,12,0.035,315000,3780000,12780000
Jarwi Pradipta,15000000,6,0.02,300000,1800000,16800000
Cahyanto Iswahyudi,10000000,3,0.03,300000,900000,10900000
Jayadi Mahardika,8000000,6,0.02,160000,960000,8960000
Irma Wahyuni,19000000,12,0.025,475000,5700000,24700000
Mursita Pranowo,11000000,6,0.025,275000,1650000,12650000
Jasmin Rahmawati,15000000,12,0.025,375000,4500000,19500000
Unggul Siregar,7000000,6,0.025,175000,1050000,8050000
Zulaikha Palastri,15000000,6,0.03,450000,2700000,17700000
Gatot Wacana,7000000,6,0.025,175000,1050000,8050000
Cornelia Rahayu,14000000,12,0.035,490000,5880000,19880000
Lulut Manullang,20000000,3,0.035,700000,2100000,22100000
Cakrabirawa Hardiansyah,7000000,6,0.035,245000,1470000,8470000
Malik Darojat,12000000,6,0.025,300000,1800000,13800000
Kairav Siregar,9000000,12,0.025,225000,2700000,11700000
Jaga Sihotang,18000000,12,0.035,630000,7560000,25560000
Shakila Aryanti,12000000,3,0.03,360000,1080000,13080000
Karen Harini,16000000,6,0.025,400000,2400000,18400000
Puspita Mustika,10000000,6,0.025,250000,1500000,11500000
Anggun Nurdiyanti,10000000,6,0.025,250000,1500000,11500000
Ajimat Iswahyudi,18000000,6,0.03,540000,3240000,21240000
Nasrullah Abiputra,9000000,3,0.025,225000,675000,9675000
Zulfa Damayanti,17000000,6,0.025,425000,2550000,19550000
Lantar Sitorus,11000000,6,0.02,220000,1320000,12320000
Ridwan Gunawan,7000000,6,0.025,175000,1050000,8050000
Cakrawangsa Oktovian,19000000,6,0.015,285000,1710000,20710000
Lulut Wibowo,19000000,12,0.015,285000,3420000,22420000
Irsad Firmansyah,15000000,3,0.02,300000,900000,15900000
Jinawi Sudrajat,20000000,6,0.025,500000,3000000,23000000
Raina Mayasari,16000000,3,0.035,560000,1680000,17680000
Naradi Santoso,14000000,12,0.025,350000,4200000,18200000
Ganda Hakim,16000000,6,0.02,320000,1920000,17920000
Calista Puspasari,19000000,3,0.035,665000,1995000,20995000
Jagaraga Oktavian,16000000,6,0.035,560000,3360000,19360000
Nasim Nugraha,8000000,12,0.03,240000,2880000,10880000
Jaiman Firgantoro,14000000,6,0.025,350000,2100000,16100000
Yessi Halimah,17000000,6,0.025,425000,2550000,19550000
Tiara Leilani,9000000,6,0.025,225000,1350000,10350000
Kasiran Maheswara,19000000,12,0.025,475000,5700000,24700000
Rika Rachmawati,15000000,12,0.025,375000,4500000,19500000
Adinata Januar,15000000,12,0.035,525000,6300000,21300000
Dimaz Ahmad,7000000,3,0.025,175000,525000,7525000
Yuliana Hasanah,12000000,3,0.035,420000,1260000,13260000
Pranawa Hakim,20000000,6,0.025,500000,3000000,23000000
Linda Pudjiastuti,6000000,6,0.03,180000,1080000,7080000
Prabowo Mandala,11000000,6,0.025,275000,1650000,12650000
Bahuraksa Airlangga,9000000,12,0.025,225000,2700000,11700000
Eman Hardiansyah,15000000,6,0.025,375000,2250000,17250000
Ikin Sirait,7000000,6,0.03,210000,1260000,8260000
Ghaliyati Anandya,7000000,6,0.035,245000,1470000,8470000
Ami Andini,17000000,12,0.035,595000,7140000,24140000
Adikara Nugraha,5000000,12,0.025,125000,1500000,6500000
Ajiman Handoko,20000000,3,0.035,700000,2100000,22100000
Muni Nugroho,20000000,3,0.025,500000,1500000,21500000
Tri Juwita,11000000,6,0.015,165000,990000,11990000
Irfan Saptono,18000000,6,0.025,450000,2700000,20700000
Unjani Salsabilla,11000000,3,0.025,275000,825000,11825000
Putu Haikal,7000000,3,0.02,140000,420000,7420000
Galih Simbolon,7000000,3,0.035,245000,735000,7735000
Purwa Suryono,15000000,12,0.025,375000,4500000,19500000
Tari Ramadhani,12000000,3,0.025,300000,900000,12900000
Adhiarja Latupono,18000000,3,0.025,450000,1350000,19350000
Hamzah Maulana,9000000,6,0.025,225000,1350000,10350000
Mursinin Napitupulu,7000000,3,0.015,105000,315000,7315000
Wardi Faresta,20000000,6,0.025,500000,3000000,23000000
Zizi Afifah,20000000,6,0.025,500000,3000000,23000000
Kusuma Hidayat,20000000,12,0.035,700000,8400000,28400000
Teddy Waluyo,14000000,6,0.035,490000,2940000,16940000
Sasha Ningrum,15000000,12,0.03,450000,5400000,20400000
Zaenab Ardiyanti,19000000,6,0.015,285000,1710000,20710000
Kajen Antoni,8000000,12,0.02,160000,1920000,9920000
Jaya Sihotang,15000000,3,0.025,375000,1125000,16125000
Natalia Halimah,20000000,6,0.025,500000,3000000,23000000
Caket Pratama,11000000,6,0.03,330000,1980000,12980000
Darimin Hutasoit,16000000,12,0.025,400000,4800000,20800000
Ditya Riyanti,14000000,6,0.03,420000,2520000,16520000
Eka Laksita,16000000,3,0.015,240000,720000,16720000
Yessi Padmasari,10000000,6,0.015,150000,900000,10900000
Ajiman Prasetya,17000000,6,0.025,425000,2550000,19550000
Cayadi Prabowo,10000000,12,0.03,300000,3600000,13600000
Kawaca Manullang,9000000,6,0.015,135000,810000,9810000
Darijan Kusumo,7000000,6,0.025,175000,1050000,8050000
Kasusra Adhitama,14000000,6,0.015,210000,1260000,15260000
Usyi Saputri,20000000,3,0.03,600000,1800000,21800000
Umi Zahrah,14000000,6,0.025,350000,2100000,16100000
Ria Handayani,6000000,6,0.015,90000,540000,6540000
Bagas Maryadi,15000000,6,0.015,225000,1350000,16350000
Vino Adhitama,18000000,6,0.02,360000,2160000,20160000
Lala Damayanti,12000000,12,0.03,360000,4320000,16320000
Mustika Wardana,6000000,6,0.02,120000,720000,6720000
Usyi Rahmawati,15000000,12,0.025,375000,4500000,19500000
Luhung Antoni,12000000,6,0.025,300000,1800000,13800000
Paiman Zulkarnain,20000000,12,0.02,400000,4800000,24800000
Irfan Purnawarman,14000000,6,0.015,210000,1260000,15260000
Damu Kuswoyo,11000000,6,0.035,385000,2310000,13310000
Opung Santoso,16000000,12,0.035,560000,6720000,22720000
Kemal Wahyudin,18000000,3,0.02,360000,1080000,19080000
Prita Hassanah,18000000,6,0.025,450000,2700000,20700000
Ibrani Purnawarman,9000000,6,0.02,180000,1080000,10080000
Damu Lesmana,17000000,12,0.03,510000,6120000,23120000
Hartaka Nainggolan,8000000,6,0.035,280000,1680000,9680000
Garang Antoni,8000000,6,0.02,160000,960000,8960000
Harja Najmudin,10000000,3,0.025,250000,750000,10750000
Wage Prasetyo,8000000,12,0.025,200000,2400000,10400000
Ganesha Haryanti,6000000,6,0.025,150000,900000,6900000
Mulyono Budiyanto,12000000,6,0.025,300000,1800000,13800000
Cawuk Sinaga,20000000,6,0.025,500000,3000000,23000000
Taufan Gunarto,11000000,6,0.015,165000,990000,11990000
Raharja Wardana,9000000,12,0.025,225000,2700000,11700000
Nadia Riyanti,20000000,3,0.025,500000,1500000,21500000
Aslijan Maulana,14000000,6,0.03,420000,2520000,16520000
Ajiono Firmansyah,12000000,6,0.035,420000,2520000,14520000
Cornelia Salsabilla,7000000,12,0.025,175000,2100000,9100000
Novita Fathina,20000000,3,0.025,500000,1500000,21500000
Dodo Haikal,16000000,6,0.025,400000,2400000,18400000
Waluyo Fabian,12000000,6,0.02,240000,1440000,13440000
Tri Afifah,16000000,6,0.015,240000,1440000,17440000
Dartono Budiman,11000000,6,0.03,330000,1980000,12980000
Kasusra Habibi,8000000,6,0.02,160000,960000,8960000
Belinda Suryatmi,14000000,12,0.02,280000,3360000,17360000
Cahyadi Darojat,10000000,12,0.03,300000,3600000,13600000
Simon Prabowo,11000000,12,0.025,275000,3300000,14300000
Mursinin Marpaung,15000000,12,0.025,375000,4500000,19500000
Cahyo Haikal,18000000,6,0.025,450000,2700000,20700000
Garan Siregar,14000000,6,0.035,490000,2940000,16940000
Sartika Aurelia,19000000,3,0.015,285000,855000,19855000
Galiono Hidayat,14000000,3,0.025,350000,1050000,15050000
Lala Hartati,9000000,12,0.025,225000,2700000,11700000
Raihan Irawan,17000000,12,0.025,425000,5100000,22100000
Dono Yudhistira,20000000,3,0.015,300000,900000,20900000
Kezia Leilani,18000000,6,0.025,450000,2700000,20700000
Sasha Saputri,9000000,6,0.015,135000,810000,9810000
Drajat Suryono,10000000,6,0.03,300000,1800000,11800000
Anom Prasasta,8000000,6,0.02,160000,960000,8960000
Karna Hutapea,9000000,3,0.035,315000,945000,9945000
Daryani Aswandi,9000000,12,0.025,225000,2700000,11700000
Rosman Thamrin,5000000,6,0.025,125000,750000,5750000
Among Kurniawan,14000000,6,0.025,350000,2100000,16100000
Icha Zulaika,6000000,3,0.025,150000,450000,6450000
Cagak Saptono,7000000,6,0.035,245000,1470000,8470000
Mustofa Megantara,5000000,12,0.025,125000,1500000,6500000
Mila Palastri,16000000,6,0.025,400000,2400000,18400000
Prabowo Febian,7000000,3,0.025,175000,525000,7525000
Ani Sudiati,16000000,6,0.03,480000,2880000,18880000
Cecep Perdana,17000000,6,0.025,425000,2550000,19550000
Cahyo Latupono,20000000,6,0.025,500000,3000000,23000000
Wisnu Arifin,11000000,3,0.035,385000,1155000,12155000
Viktor Pranowo,10000000,6,0.035,350000,2100000,12100000
Ajeng Mahestri,9000000,3,0.025,225000,675000,9675000
Samsul Sinaga,16000000,3,0.03,480000,1440000,17440000
Banara Nanda,9000000,6,0.02,180000,1080000,10080000
Tasnim Sitorus,8000000,3,0.035,280000,840000,8840000
Raden Nainggolan,11000000,12,0.035,385000,4620000,15620000
Hesti Uyainah,8000000,6,0.025,200000,1200000,9200000
Darmana Agustian,11000000,6,0.02,220000,1320000,12320000
Viktor Purwadi,17000000,3,0.025,425000,1275000,18275000
Harto Nashiruddin,15000000,6,0.015,225000,1350000,16350000
Cengkal Mangunsong,15000000,3,0.035,525000,1575000,16575000
Cinta Hartati,10000000,3,0.035,350000,1050000,11050000
Ria Sudiati,17000000,12,0.025,425000,5100000,22100000
Lukita Wibowo,8000000,12,0.02,160000,1920000,9920000
Wardi Sudrajat,11000000,6,0.025,275000,1650000,12650000
Padma Nuraini,12000000,12,0.02,240000,2880000,14880000
Slamet Darmawan,12000000,12,0.025,300000,3600000,15600000
Raditya Antoni,18000000,6,0.025,450000,2700000,20700000
Estiono Mustofa,6000000,6,0.025,150000,900000,6900000
Raden Ardana,5000000,3,0.025,125000,375000,5375000
Lega Wibowo,14000000,3,0.025,350000,1050000,15050000
Naradi Dirgantara,15000000,3,0.025,375000,1125000,16125000
Gaduh Santoso,19000000,6,0.015,285000,1710000,20710000
Diah Yolanda,11000000,3,0.025,275000,825000,11825000
Gading Yudhistira,9000000,3,0.025,225000,675000,9675000
Safina Aryani,12000000,3,0.03,360000,1080000,13080000
Jono Lesmana,17000000,12,0.025,425000,5100000,22100000
Dian Puspasari,19000000,6,0.025,475000,2850000,21850000
Gamani Rayhan,7000000,12,0.025,175000,2100000,9100000
Rosman Darmawan,8000000,3,0.035,280000,840000,8840000
Emas Irawan,5000000,6,0.035,175000,1050000,6050000
Prima Waluyo,18000000,3,0.025,450000,1350000,19350000
Linda Azizah,20000000,6,0.035,700000,4200000,24200000
Galiono Hutasoit,16000000,3,0.035,560000,1680000,17680000
Among Nugroho,16000000,6,0.035,560000,3360000,19360000
Mahesa Airlangga,18000000,3,0.035,630000,1890000,19890000
Caraka Syahreza,9000000,3,0.02,180000,540000,9540000
Mumpuni Hidayanto,17000000,6,0.025,425000,2550000,19550000
Sadina Uyainah,12000000,6,0.03,360000,2160000,14160000
Gabriella Widiastuti,15000000,6,0.025,375000,2250000,17250000
Anita Pudjiastuti,7000000,12,0.025,175000,2100000,9100000
Mahmud Ahmad,8000000,6,0.03,240000,1440000,9440000
Dipa Febian,17000000,6,0.03,510000,3060000,20060000
Rachel Zahrah,7000000,6,0.025,175000,1050000,8050000
Liman Yulianto,19000000,6,0.035,665000,3990000,22990000
Darmanto Irawan,7000000,3,0.025,175000,525000,7525000
Fara Elvina,16000000,3,0.015,240000,720000,16720000
Tri Suryatmi,10000000,6,0.025,250000,1500000,11500000
Darimin Kusumo,20000000,12,0.025,500000,6000000,26000000
Kenari Nainggolan,19000000,6,0.025,475000,2850000,21850000
Mulya Rayhan,15000000,3,0.02,300000,900000,15900000
Paiman Wibisono,14000000,3,0.025,350000,1050000,15050000
Adinata Siregar,16000000,12,0.025,400000,4800000,20800000
Kenari Mahendra,18000000,3,0.02,360000,1080000,19080000
Cawisono Pranowo,15000000,6,0.035,525000,3150000,18150000
Indra Wicaksono,8000000,6,0.035,280000,1680000,9680000
Kusuma Najmudin,16000000,12,0.03,480000,5760000,21760000
Retno Jelita,20000000,3,0.02,400000,1200000,21200000
Cinthia Aurelia,17000000,6,0.025,425000,2550000,19550000
Hamima Yulianti,10000000,3,0.025,250000,750000,10750000
Balangga Maheswara,14000000,3,0.035,490000,1470000,15470000
Yono Darmawan,15000000,6,0.015,225000,1350000,16350000
Sabar Hakim,9000000,3,0.025,225000,675000,9675000
Hardi Damanik,17000000,6,0.03,510000,3060000,20060000
Prayoga Wibisono,20000000,6,0.025,500000,3000000,23000000
Fitria Usamah,10000000,3,0.02,200000,600000,10600000
Ani Wastuti,17000000,6,0.02,340000,2040000,19040000
Siti Kuswandari,14000000,3,0.03,420000,1260000,15260000
Bahuraksa Bagaskara,9000000,3,0.02,180000,540000,9540000
Emong Pranowo,12000000,12,0.015,180000,2160000,14160000
Cemani Aswandi,7000000,12,0.015,105000,1260000,8260000
Gantar Mangunsong,17000000,3,0.025,425000,1275000,18275000
Jabal Suryono,8000000,6,0.025,200000,1200000,9200000
Kasiyah Palastri,16000000,6,0.035,560000,3360000,19360000
Paramita Maharani,19000000,3,0.02,380000,1140000,20140000
Tantri Harini,11000000,3,0.025,275000,825000,11825000
Laila Kusuma,20000000,3,0.035,700000,2100000,22100000
Olivia Wastuti,9000000,6,0.025,225000,1350000,10350000
Luhung Haryanto,7000000,3,0.025,175000,525000,7525000
Jais Mangunsong,15000000,3,0.035,525000,1575000,16575000
Daru Supriyanto,12000000,3,0.035,420000,1260000,13260000
Jasmani Narpati,16000000,3,0.035,560000,1680000,17680000
Emong Utama,6000000,12,0.025,150000,1800000,7800000
Asirwanda Uwais,15000000,3,0.035,525000,1575000,16575000
Aswani Tampubolon,14000000,3,0.025,350000,1050000,15050000
Candra Nashiruddin,14000000,3,0.03,420000,1260000,15260000
Diah Salsabilla,12000000,6,0.035,420000,2520000,14520000
Jais Pradana,5000000,12,0.025,125000,1500000,6500000
Amelia Wulandari,15000000,6,0.015,225000,1350000,16350000
Adika Budiyanto,15000000,6,0.025,375000,2250000,17250000
Hadi Herlambang,8000000,6,0.035,280000,1680000,9680000
Cahyo Rajata,5000000,3,0.03,150000,450000,5450000
Farhunnisa Kusmawati,18000000,3,0.015,270000,810000,18810000
Prayitna Wibowo,7000000,3,0.025,175000,525000,7525000
Ega Pradipta,12000000,6,0.035,420000,2520000,14520000
Jabal Haikal,14000000,3,0.025,350000,1050000,15050000
Puput Rahimah,15000000,3,0.03,450000,1350000,16350000
Gara Setiawan,5000000,6,0.025,125000,750000,5750000
Kala Antoni,17000000,12,0.025,425000,5100000,22100000
Kenzie Hutapea,15000000,3,0.02,300000,900000,15900000
Gilang Supriyanto,12000000,3,0.03,360000,1080000,13080000
Enteng Wibowo,12000000,12,0.025,300000,3600000,15600000
Ciaobella Saraswati,15000000,6,0.02,300000,1800000,16800000
Gandi Nababan,8000000,3,0.02,160000,480000,8480000
Dwi Palastri,10000000,6,0.025,250000,1500000,11500000
Zaenab Nurdiyanti,11000000,3,0.02,220000,660000,11660000
Harjo Mahendra,14000000,12,0.035,490000,5880000,19880000
Bella Yulianti,17000000,12,0.025,425000,5100000,22100000
Karna Lesmana,17000000,12,0.03,510000,6120000,23120000
Cahyono Hidayat,8000000,3,0.025,200000,600000,8600000
Luwar Sihombing,8000000,6,0.015,120000,720000,8720000
Kayun Irawan,9000000,3,0.02,180000,540000,9540000
Sari Laksita,15000000,3,0.035,525000,1575000,16575000
Karen Mustika,17000000,6,0.02,340000,2040000,19040000
Irsad Hermawan,10000000,12,0.025,250000,3000000,13000000
Dewi Andriani,5000000,12,0.025,125000,1500000,6500000
Ilsa Anggraini,16000000,3,0.03,480000,1440000,17440000
Jaeman Wibowo,14000000,3,0.02,280000,840000,14840000
Puput Agustina,14000000,6,0.025,350000,2100000,16100000
Nasab Thamrin,7000000,12,0.025,175000,2100000,9100000
Galak Ahmad,11000000,6,0.03,330000,1980000,12980000
Kasiran Rayhan,15000000,3,0.015,225000,675000,15675000
Indira Aryanti,11000000,6,0.035,385000,2310000,13310000
Candrakanta Putra,18000000,6,0.02,360000,2160000,20160000
Hasan Pratama,19000000,6,0.035,665000,3990000,22990000
Dwi Januar,5000000,6,0.02,100000,600000,5600000
Melinda Laksmiwati,7000000,3,0.015,105000,315000,7315000
Widya Azizah,14000000,6,0.035,490000,2940000,16940000
Ridwan Hutapea,18000000,12,0.025,450000,5400000,23400000
Harimurti Hakim,20000000,12,0.02,400000,4800000,24800000
Himawan Ramadan,9000000,12,0.025,225000,2700000,11700000
Gawati Amanta,19000000,6,0.025,475000,2850000,21850000
Arsipatra Tamba,20000000,12,0.025,500000,6000000,26000000
Gandewa Purnama,10000000,12,0.02,200000,2400000,12400000
Bakiono Simbolon,10000000,6,0.035,350000,2100000,12100000
Ciaobella Riyanti,19000000,6,0.025,475000,2850000,21850000
Irawati Pertiwi,15000000,6,0.03,450000,2700000,17700000
Oman Mahardika,11000000,6,0.025,275000,1650000,12650000
Rendy Nainggolan,8000000,12,0.025,200000,2400000,10400000
Mumpuni Uwais,6000000,6,0.025,150000,900000,6900000
Jaiman Tarihoran,18000000,6,0.02,360000,2160000,20160000
Mulyono Uwais,18000000,6,0.025,450000,2700000,20700000
Tsabita Ningrum,7000000,6,0.035,245000,1470000,8470000
Putri Mustika,14000000,6,0.025,350000,2100000,16100000
Yessi Ardiyanti,15000000,12,0.035,525000,6300000,21300000
Paulin Nasyiah,11000000,3,0.015,165000,495000,11495000
Zaenab Azizah,17000000,3,0.025,425000,1275000,18275000
Ivan Satria,8000000,6,0.025,200000,1200000,9200000
Kirana Purnawati,9000000,12,0.025,225000,2700000,11700000
Ella Maryati,9000000,3,0.025,225000,675000,9675000
Tsabita Amanta,20000000,6,0.025,500000,3000000,23000000
Rosa Mardhiyah,14000000,3,0.025,350000,1050000,15050000
Lurhur Ardianto,16000000,12,0.025,400000,4800000,20800000
Maryadi Airlangga,18000000,6,0.025,450000,2700000,20700000
Hairyanto Narpati,11000000,6,0.025,275000,1650000,12650000
Rama Natsir,14000000,6,0.015,210000,1260000,15260000
Daryani Siregar,17000000,12,0.02,340000,4080000,21080000
Farah Harini,19000000,3,0.015,285000,855000,19855000
Ilsa Andriani,10000000,6,0.035,350000,2100000,12100000
Rahmat Sihombing,7000000,12,0.015,105000,1260000,8260000
Septi Padmasari,14000000,12,0.025,350000,4200000,18200000
Gara Faresta,16000000,6,0.025,400000,2400000,18400000
Prayoga Oktovian,10000000,6,0.015,150000,900000,10900000
Vero Yanuar,14000000,3,0.035,490000,1470000,15470000
Sintia Nasyiah,8000000,12,0.02,160000,1920000,9920000
Gantar Prasetya,9000000,6,0.035,315000,1890000,10890000
Dasa Simanjuntak,6000000,12,0.025,150000,1800000,7800000
Cawuk Simanjuntak,9000000,3,0.025,225000,675000,9675000
Estiono Satria,20000000,3,0.025,500000,1500000,21500000
Puspita Kusmawati,15000000,12,0.035,525000,6300000,21300000
Oman Hidayanto,6000000,6,0.015,90000,540000,6540000
Nabila Puspasari,11000000,3,0.025,275000,825000,11825000
Reza Hutagalung,18000000,3,0.025,450000,1350000,19350000
Rika Febrianti,20000000,6,0.025,500000,3000000,23000000
Carub Sihombing,18000000,3,0.03,540000,1620000,19620000
Tami Salsabilla,5000000,6,0.025,125000,750000,5750000
Jumadi Wasita,11000000,3,0.015,165000,495000,11495000
Ami Salma,10000000,6,0.025,250000,1500000,11500000
Michelle Ningrum,7000000,6,0.015,105000,630000,7630000
Laras Halimah,6000000,12,0.025,150000,1800000,7800000
Raharja Gunawan,17000000,6,0.025,425000,2550000,19550000
Yosef Hardiansyah,19000000,3,0.015,285000,855000,19855000
Vivi Wahyuni,9000000,6,0.035,315000,1890000,10890000
Irawati Mulyani,19000000,3,0.015,285000,855000,19855000
Wasis Purnawarman,15000000,6,0.015,225000,1350000,16350000
Cemplunk Najmudin,17000000,3,0.025,425000,1275000,18275000
Violet Pertiwi,19000000,12,0.015,285000,3420000,22420000
Daliman Tampubolon,12000000,6,0.025,300000,1800000,13800000
Bajragin Situmorang,18000000,6,0.035,630000,3780000,21780000
Malik Simanjuntak,18000000,3,0.015,270000,810000,18810000
Laksana Simanjuntak,20000000,3,0.025,500000,1500000,21500000
Ian Prasetya,14000000,3,0.02,280000,840000,14840000
Febrina Harini,15000000,3,0.025,375000,1125000,16125000
Hadi Maheswara,18000000,3,0.015,270000,810000,18810000
Lili Palastri,11000000,6,0.015,165000,990000,11990000
Banara Simbolon,12000000,3,0.03,360000,1080000,13080000
Karna Narpati,8000000,3,0.025,200000,600000,8600000
Fitri Jelita,16000000,3,0.025,400000,1200000,17200000
Rahman Waskita,10000000,3,0.035,350000,1050000,11050000
Zelaya Laksita,18000000,3,0.025,450000,1350000,19350000
Vinsen Bagaskara,20000000,6,0.025,500000,3000000,23000000
Limar Manullang,15000000,3,0.015,225000,675000,15675000
Rosman Damanik,15000000,6,0.015,225000,1350000,16350000
Malika Andriani,6000000,3,0.02,120000,360000,6360000
Heru Antoni,17000000,3,0.025,425000,1275000,18275000
Ivan Nainggolan,17000000,12,0.03,510000,6120000,23120000
Indira Putri,19000000,12,0.015,285000,3420000,22420000
Ridwan Pradana,14000000,12,0.03,420000,5040000,19040000
Arsipatra Mahendra,12000000,12,0.025,300000,3600000,15600000
Ibrani Rendra,10000000,12,0.025,250000,3000000,13000000
Cahyono Wasita,6000000,6,0.035,210000,1260000,7260000
Liman Situmorang,12000000,6,0.035,420000,2520000,14520000
Elvina Widiastuti,5000000,3,0.025,125000,375000,5375000
Aditya Alamsyah,20000000,3,0.025,500000,1500000,21500000
Opung Alamsyah,19000000,3,0.035,665000,1995000,20995000
Kirana Laksmiwati,19000000,3,0.035,665000,1995000,20995000
Yunita Riyanti,9000000,6,0.015,135000,810000,9810000
Zaenab Ardiyanti,7000000,6,0.025,175000,1050000,8050000
Prasetyo Satria,10000000,3,0.035,350000,1050000,11050000
Karja Febian,14000000,6,0.025,350000,2100000,16100000
Heryanto Suryono,17000000,12,0.02,340000,4080000,21080000
Embuh Prasetyo,17000000,12,0.03,510000,6120000,23120000
Wawan Faresta,7000000,3,0.035,245000,735000,7735000
Sakti Syahreza,7000000,3,0.035,245000,735000,7735000
Tri Hutagalung,11000000,6,0.025,275000,1650000,12650000
Olga Hakim,11000000,12,0.035,385000,4620000,15620000
Galiono Antoni,10000000,6,0.025,250000,1500000,11500000
Limar Budiyanto,17000000,3,0.035,595000,1785000,18785000
Gaman Siregar,8000000,6,0.03,240000,1440000,9440000
Daniswara Maulana,20000000,3,0.015,300000,900000,20900000
Bakda Salahudin,20000000,6,0.035,700000,4200000,24200000
Eka Pangestu,14000000,12,0.02,280000,3360000,17360000
Fitria Lailasari,7000000,6,0.02,140000,840000,7840000
Among Ardana,8000000,6,0.035,280000,1680000,9680000
Muni Marpaung,9000000,6,0.025,225000,1350000,10350000
Hasim Fabian,8000000,3,0.02,160000,480000,8480000
Gilang Pranowo,10000000,6,0.025,250000,1500000,11500000
Sari Hastuti,15000000,6,0.035,525000,3150000,18150000
Danuja Prasasta,9000000,6,0.035,315000,1890000,10890000
Jagaraga Anggriawan,10000000,6,0.025,250000,1500000,11500000
Cager Budiman,11000000,12,0.02,220000,2640000,13640000
Luis Oktavian,19000000,6,0.025,475000,2850000,21850000
Puput Azzahra,20000000,6,0.025,500000,3000000,23000000
Tina Haryanti,20000000,6,0.025,500000,3000000,23000000
Kemal Pranowo,11000000,6,0.03,330000,1980000,12980000
Halima Hartati,18000000,3,0.025,450000,1350000,19350000
Warta Pradipta,11000000,12,0.02,220000,2640000,13640000
Wage Hutapea,12000000,3,0.02,240000,720000,12720000
Galang Gunawan,16000000,3,0.035,560000,1680000,17680000
Hana Salsabilla,12000000,12,0.035,420000,5040000,17040000
Gambira Saragih,11000000,3,0.03,330000,990000,11990000
Garda Suryono,7000000,3,0.025,175000,525000,7525000
Emas Pratama,19000000,12,0.025,475000,5700000,24700000
Pia Purnama,5000000,6,0.035,175000,1050000,6050000
Unjani Wijayanti,7000000,12,0.015,105000,1260000,8260000
Kayun Adriansyah,9000000,6,0.025,225000,1350000,10350000
Agustina Anjani,18000000,3,0.025,450000,1350000,19350000
Daliono Oktavian,18000000,6,0.035,630000,3780000,21780000
Janet Permata,19000000,6,0.025,475000,2850000,21850000
Baktianto Purnawarman,20000000,12,0.02,400000,4800000,24800000
Mahmud Waskita,11000000,6,0.015,165000,990000,11990000
Wage Irawan,9000000,3,0.015,135000,405000,9405000
Ganda Latupono,7000000,6,0.025,175000,1050000,8050000
Gandewa Uwais,16000000,12,0.025,400000,4800000,20800000
Ami Amanta,14000000,6,0.025,350000,2100000,16100000
Dodo Ahmad,9000000,6,0.025,225000,1350000,10350000
Endra Situmorang,6000000,6,0.025,150000,900000,6900000
Ikin Pradipta,7000000,3,0.025,175000,525000,7525000
Anastasia Kuswandari,6000000,6,0.025,150000,900000,6900000
Nugraha Setiawan,9000000,3,0.02,180000,540000,9540000
Pardi Ardana,7000000,6,0.015,105000,630000,7630000
Calista Hassanah,20000000,12,0.035,700000,8400000,28400000
Luis Maryadi,20000000,3,0.025,500000,1500000,21500000
Wawan Fabian,20000000,6,0.035,700000,4200000,24200000
Martana Sihombing,14000000,6,0.02,280000,1680000,15680000
Aslijan Maulana,15000000,6,0.025,375000,2250000,17250000
Gantar Wijaya,19000000,6,0.025,475000,2850000,21850000
Cemplunk Adriansyah,8000000,3,0.025,200000,600000,8600000
Najib Airlangga,15000000,12,0.015,225000,2700000,17700000
Jais Simbolon,20000000,6,0.025,500000,3000000,23000000
Emas Rayhan,11000000,12,0.02,220000,2640000,13640000
Ihsan Maheswara,16000000,12,0.035,560000,6720000,22720000
Langgeng Ramadan,14000000,6,0.015,210000,1260000,15260000
Wira Prabowo,16000000,3,0.02,320000,960000,16960000
Vania Nuraini,10000000,12,0.025,250000,3000000,13000000
Halima Melinda,17000000,6,0.025,425000,2550000,19550000
Dariati Manullang,10000000,6,0.03,300000,1800000,11800000
Sakti Mangunsong,9000000,6,0.02,180000,1080000,10080000
Kuncara Saputra,7000000,3,0.02,140000,420000,7420000
Safira Kusmawati,14000000,6,0.035,490000,2940000,16940000
Wadi Nashiruddin,20000000,3,0.03,600000,1800000,21800000
Cagak Sirait,14000000,6,0.025,350000,2100000,16100000
Lutfan Utama,6000000,6,0.025,150000,900000,6900000
Ganda Sihombing,15000000,3,0.02,300000,900000,15900000
Tedi Rayhan,18000000,3,0.02,360000,1080000,19080000
Atmaja Natsir,12000000,6,0.015,180000,1080000,13080000
Calista Pratiwi,6000000,6,0.015,90000,540000,6540000
Lutfan Santoso,15000000,6,0.025,375000,2250000,17250000
Lulut Purnama,12000000,6,0.02,240000,1440000,13440000
Ganesha Maharani,20000000,12,0.035,700000,8400000,28400000
Ivan Mahendra,14000000,6,0.035,490000,2940000,16940000
Iriana Uyainah,11000000,12,0.035,385000,4620000,15620000
Zalindra Hassanah,16000000,6,0.025,400000,2400000,18400000
Kariman Handoko,18000000,6,0.025,450000,2700000,20700000
Koko Pratama,18000000,6,0.02,360000,2160000,20160000
Sidiq Hutagalung,9000000,6,0.03,270000,1620000,10620000
Cici Astuti,17000000,6,0.025,425000,2550000,19550000
Eluh Purnama,8000000,6,0.035,280000,1680000,9680000
Kenes Iswahyudi,8000000,6,0.035,280000,1680000,9680000
Damu Suwarno,10000000,6,0.015,150000,900000,10900000
Lutfan Rendra,8000000,6,0.02,160000,960000,8960000
Daryani Setiawan,6000000,6,0.015,90000,540000,6540000
Cagak Simbolon,12000000,12,0.025,300000,3600000,15600000
Pangeran Agustian,20000000,6,0.015,300000,1800000,21800000
Luthfi Sinaga,11000000,3,0.015,165000,495000,11495000
Indira Pudjiastuti,9000000,6,0.025,225000,1350000,10350000
Prayitna Satria,20000000,3,0.02,400000,1200000,21200000
Martani Setiawan,14000000,3,0.035,490000,1470000,15470000
Slamet Wahyudin,12000000,6,0.015,180000,1080000,13080000
Nardi Salahudin,7000000,6,0.025,175000,1050000,8050000
Raihan Hutagalung,20000000,6,0.035,700000,4200000,24200000
Diana Prastuti,16000000,12,0.035,560000,6720000,22720000
Tantri Halimah,12000000,6,0.035,420000,2520000,14520000
Tantri Purnama,16000000,6,0.03,480000,2880000,18880000
Kayla Amanta,11000000,3,0.015,165000,495000,11495000
Vanesa Aurelia,8000000,3,0.035,280000,840000,8840000
Hasan Latupono,14000000,6,0.035,490000,2940000,16940000
Candra Mahendra,10000000,3,0.025,250000,750000,10750000
Amelia Nuraini,11000000,3,0.025,275000,825000,11825000
Opung Setiawan,15000000,3,0.035,525000,1575000,16575000
Halima Anjani,18000000,3,0.03,540000,1620000,19620000
Dimaz Wacana,14000000,3,0.035,490000,1470000,15470000
Irsad Darmawan,19000000,6,0.025,475000,2850000,21850000
Sakura Novitasari,14000000,6,0.025,350000,2100000,16100000
Wadi Pradana,9000000,6,0.025,225000,1350000,10350000
Jaswadi Anggriawan,17000000,6,0.025,425000,2550000,19550000
Paiman Arifin,20000000,6,0.035,700000,4200000,24200000
Prayogo Irfandi,18000000,6,0.025,450000,2700000,20700000
Gada Mustofa,9000000,6,0.015,135000,810000,9810000
Galak Halim,10000000,6,0.025,250000,1500000,11500000
Samiah Yulianti,8000000,3,0.035,280000,840000,8840000
Galih Hardiansyah,9000000,3,0.03,270000,810000,9810000
Hartana Prasetya,9000000,3,0.035,315000,945000,9945000
Gada Setiawan,5000000,6,0.015,75000,450000,5450000
Hilda Hassanah,14000000,6,0.02,280000,1680000,15680000
Wira Prasetyo,6000000,6,0.035,210000,1260000,7260000
Nur Ananda,7000000,12,0.015,105000,1260000,8260000
Nadia Nasyidah,5000000,6,0.025,125000,750000,5750000
Baktiono Gunawan,16000000,3,0.02,320000,960000,16960000
Emin Uwais,7000000,6,0.025,175000,1050000,8050000
Genta Jelita,16000000,6,0.035,560000,3360000,19360000
Soleh Abiputra,17000000,6,0.025,425000,2550000,19550000
Gangsa Sudrajat,20000000,12,0.035,700000,8400000,28400000
Bakda Febian,11000000,6,0.02,220000,1320000,12320000
Putri Palastri,10000000,6,0.025,250000,1500000,11500000
Elvina Hartati,9000000,6,0.025,225000,1350000,10350000
Titi Mahestri,16000000,3,0.035,560000,1680000,17680000
Rahayu Astuti,9000000,6,0.03,270000,1620000,10620000
Cayadi Yanuar,8000000,6,0.035,280000,1680000,9680000
Galar Winarno,11000000,6,0.025,275000,1650000,12650000
Martani Saputra,8000000,6,0.035,280000,1680000,9680000
Koko Purwadi,11000000,12,0.025,275000,3300000,14300000
Yono Bagaskara,17000000,6,0.02,340000,2040000,19040000
Indah Yuliarti,15000000,12,0.025,375000,4500000,19500000
Digdaya Simanjuntak,15000000,6,0.025,375000,2250000,17250000
Maras Rajasa,10000000,6,0.025,250000,1500000,11500000
Pangestu Supriyanto,17000000,12,0.02,340000,4080000,21080000
Tina Prastuti,8000000,6,0.035,280000,1680000,9680000
Ghaliyati Nathania,11000000,6,0.025,275000,1650000,12650000
Umar Wardana,12000000,3,0.035,420000,1260000,13260000
Jaswadi Anggriawan,12000000,12,0.035,420000,5040000,17040000
Tirtayasa Santoso,18000000,3,0.035,630000,1890000,19890000
Artawan Pradipta,6000000,6,0.035,210000,1260000,7260000
Kartika Yolanda,5000000,3,0.03,150000,450000,5450000
Sabar Samosir,14000000,6,0.035,490000,2940000,16940000
Yessi Ardiyanti,15000000,3,0.025,375000,1125000,16125000
Hardana Mustofa,19000000,6,0.025,475000,2850000,21850000
Maryanto Prakasa,11000000,3,0.02,220000,660000,11660000
Raditya,9000000,3,0.025,225000,675000,9675000
Mumpuni Fabian,12000000,3,0.035,420000,1260000,13260000
Karen Saraswati,17000000,12,0.035,595000,7140000,24140000
Sabrina Saraswati,19000000,6,0.025,475000,2850000,21850000
Jamil Wijaya,7000000,3,0.025,175000,525000,7525000
Mulyanto Yudhistira,8000000,6,0.035,280000,1680000,9680000
Gilang Mandala,5000000,3,0.025,125000,375000,5375000
Eka Azzahra,18000000,3,0.015,270000,810000,18810000
Bagas Fabian,20000000,6,0.02,400000,2400000,22400000
Harsaya Haikal,16000000,6,0.015,240000,1440000,17440000
Wira Sitompul,16000000,3,0.02,320000,960000,16960000
Ganjaran Januar,18000000,6,0.025,450000,2700000,20700000
Ajeng Leilani,9000000,6,0.025,225000,1350000,10350000
Kariman Zulkarnain,17000000,12,0.02,340000,4080000,21080000
Panca Halim,12000000,6,0.025,300000,1800000,13800000
Wira Najmudin,15000000,3,0.025,375000,1125000,16125000
Danu Tampubolon,7000000,12,0.03,210000,2520000,9520000
Karsana Megantara,8000000,12,0.03,240000,2880000,10880000
Setya Supriyanto,17000000,3,0.02,340000,1020000,18020000
Radit Mangunsong,7000000,6,0.015,105000,630000,7630000
Gilang Ardana,19000000,6,0.02,380000,2280000,21280000
Dadi Alamsyah,7000000,6,0.025,175000,1050000,8050000
Vega Widodo,16000000,6,0.025,400000,2400000,18400000
Maman Sirait,10000000,3,0.035,350000,1050000,11050000
Paris Wastuti,20000000,3,0.025,500000,1500000,21500000
Endra Febian,19000000,6,0.02,380000,2280000,21280000
Hasta Pangestu,15000000,6,0.025,375000,2250000,17250000
Prasetya Supriyanto,14000000,3,0.015,210000,630000,14630000
Gadang Irfandi,16000000,12,0.025,400000,4800000,20800000
Rangga Jailani,18000000,6,0.025,450000,2700000,20700000
Aris Permadi,15000000,3,0.03,450000,1350000,16350000
Hasna Kusmawati,8000000,6,0.02,160000,960000,8960000
Danu Nugroho,16000000,3,0.03,480000,1440000,17440000
Febi Maryati,20000000,3,0.02,400000,1200000,21200000
Usyi Purnawati,17000000,6,0.03,510000,3060000,20060000
Balapati Antoni,10000000,6,0.025,250000,1500000,11500000
Gawati Kahyang,14000000,6,0.025,350000,2100000,16100000
Eman Syahreza,15000000,3,0.025,375000,1125000,16125000
Karsa Nugroho,9000000,3,0.025,225000,675000,9675000
Arta Haikal,17000000,12,0.035,595000,7140000,24140000
Prayitna Tarihoran,20000000,3,0.025,500000,1500000,21500000
Jagaraga Prakasa,10000000,6,0.035,350000,2100000,12100000
Kayla Padmasari,17000000,6,0.015,255000,1530000,18530000
Cahya Kusumo,14000000,3,0.025,350000,1050000,15050000
Bakianto Wacana,9000000,6,0.035,315000,1890000,10890000
Argono Wijaya,12000000,12,0.02,240000,2880000,14880000
Kartika Saputri,7000000,6,0.025,175000,1050000,8050000
Nabila Damayanti,17000000,6,0.03,510000,3060000,20060000
Dodo Bagaskara,8000000,3,0.025,200000,600000,8600000
Nalar Yulianto,16000000,3,0.025,400000,1200000,17200000
Nimas Ardiyanti,19000000,12,0.02,380000,4560000,23560000
Clara Anjani,11000000,6,0.035,385000,2310000,13310000
Cecep Sabian,20000000,3,0.015,300000,900000,20900000
Jaga Pradana,9000000,6,0.02,180000,1080000,10080000
Karta Kuswoyo,7000000,6,0.025,175000,1050000,8050000
Aris Tamba,15000000,3,0.02,300000,900000,15900000
Harsana Dirgantara,12000000,12,0.025,300000,3600000,15600000
Cakrabirawa Hutapea,16000000,6,0.015,240000,1440000,17440000
Natalia Kusuma,6000000,12,0.035,210000,2520000,8520000
Perkasa Jailani,15000000,12,0.015,225000,2700000,17700000
Rahmi Puspasari,14000000,12,0.025,350000,4200000,18200000
Gawati Astuti,14000000,6,0.02,280000,1680000,15680000
Niyaga Ardana,12000000,6,0.03,360000,2160000,14160000
Langgeng Thamrin,5000000,6,0.025,125000,750000,5750000
Bahuraksa Prayoga,15000000,12,0.02,300000,3600000,18600000
Kawaca Wacana,15000000,6,0.025,375000,2250000,17250000
Sakura Sudiati,8000000,3,0.035,280000,840000,8840000
Kezia Damayanti,5000000,6,0.035,175000,1050000,6050000
Pratiwi Oktaviani,18000000,3,0.02,360000,1080000,19080000
Cahyo Damanik,7000000,6,0.03,210000,1260000,8260000
Nyana Rajata,12000000,6,0.02,240000,1440000,13440000
Nrima Adriansyah,14000000,12,0.015,210000,2520000,16520000
Hari Simanjuntak,15000000,6,0.025,375000,2250000,17250000
Ellis Zulaika,5000000,3,0.025,125000,375000,5375000
Xanana Simanjuntak,17000000,12,0.025,425000,5100000,22100000
Rama Saptono,15000000,3,0.025,375000,1125000,16125000
Hardana Ahmad,12000000,6,0.025,300000,1800000,13800000
Tania Winarsih,12000000,3,0.035,420000,1260000,13260000
Karsa Maryadi,15000000,3,0.025,375000,1125000,16125000
Banawa Hutapea,8000000,6,0.035,280000,1680000,9680000
Elon Mangunsong,10000000,6,0.035,350000,2100000,12100000
Candrakanta Pradipta,11000000,6,0.025,275000,1650000,12650000
Ismail Saragih,14000000,6,0.025,350000,2100000,16100000
Budi Wacana,17000000,6,0.025,425000,2550000,19550000
Yunita Nathania,17000000,3,0.015,255000,765000,17765000
Kani Zahrah,8000000,6,0.03,240000,1440000,9440000
Lidya Aurelia,8000000,6,0.025,200000,1200000,9200000
Gamanto Nugroho,9000000,3,0.025,225000,675000,9675000
Jane Hassanah,15000000,6,0.025,375000,2250000,17250000
Praba Budiman,17000000,6,0.02,340000,2040000,19040000
Virman Nainggolan,10000000,6,0.025,250000,1500000,11500000
Jumari Budiyanto,5000000,6,0.02,100000,600000,5600000
Yunita Nuraini,16000000,6,0.035,560000,3360000,19360000
Prakosa Nugroho,14000000,6,0.025,350000,2100000,16100000
Almira Puspasari,14000000,6,0.03,420000,2520000,16520000
Genta Ningrum,7000000,6,0.035,245000,1470000,8470000
Zelaya Suartini,11000000,3,0.02,220000,660000,11660000
Ismail Utama,15000000,6,0.025,375000,2250000,17250000
Dipa Nugroho,11000000,12,0.03,330000,3960000,14960000
Retno Anjani,18000000,3,0.015,270000,810000,18810000
Gamblang Saefullah,19000000,6,0.025,475000,2850000,21850000
Catur Sinaga,5000000,12,0.035,175000,2100000,7100000
Hana Yuniar,7000000,12,0.035,245000,2940000,9940000
Violet Salsabilla,14000000,6,0.025,350000,2100000,16100000
Indira Purnawati,18000000,6,0.025,450000,2700000,20700000
Warta Sudrajat,20000000,6,0.025,500000,3000000,23000000
Caturangga Yudhistira,9000000,3,0.02,180000,540000,9540000
Kemal Aswandi,19000000,12,0.02,380000,4560000,23560000
Purwanto Nababan,20000000,3,0.025,500000,1500000,21500000
Ozy Purwadi,10000000,6,0.03,300000,1800000,11800000
Raina Zahrah,10000000,6,0.025,250000,1500000,11500000
Bakiman Nugraha,19000000,6,0.03,570000,3420000,22420000
Karja Ramadan,15000000,3,0.025,375000,1125000,16125000
Tirta Suwarno,11000000,6,0.015,165000,990000,11990000
Violet Nathania,8000000,6,0.035,280000,1680000,9680000
Agustina Pratiwi,6000000,6,0.015,90000,540000,6540000
Heru Syahreza,18000000,6,0.025,450000,2700000,20700000
Praba Rayhan,18000000,3,0.02,360000,1080000,19080000
Rangga Marbun,7000000,6,0.025,175000,1050000,8050000
Violet Rahayu,14000000,3,0.03,420000,1260000,15260000
Erik Megantara,15000000,3,0.02,300000,900000,15900000
Ajimin Irawan,11000000,12,0.03,330000,3960000,14960000
Julia Damayanti,17000000,12,0.02,340000,4080000,21080000
Panca Wacana,8000000,3,0.035,280000,840000,8840000
Makuta Aswandi,9000000,12,0.015,135000,1620000,10620000
Harimurti Nashiruddin,9000000,6,0.025,225000,1350000,10350000
Prayogo Thamrin,20000000,6,0.025,500000,3000000,23000000
Panca Rendra,14000000,3,0.025,350000,1050000,15050000
Respati Damanik,16000000,6,0.025,400000,2400000,18400000
Kartika Kuswandari,18000000,3,0.025,450000,1350000,19350000
Tantri Salsabilla,11000000,6,0.02,220000,1320000,12320000
Rangga Sitorus,14000000,12,0.025,350000,4200000,18200000
Aulia Wahyuni,17000000,6,0.035,595000,3570000,20570000
Bakti Napitupulu,19000000,6,0.035,665000,3990000,22990000
Maida Kuswandari,10000000,3,0.025,250000,750000,10750000
Elvin Pradipta,7000000,6,0.025,175000,1050000,8050000
Balangga Waskita,14000000,12,0.02,280000,3360000,17360000
Calista Azzahra,16000000,6,0.03,480000,2880000,18880000
Nugraha Mangunsong,10000000,6,0.03,300000,1800000,11800000
Rosa Namaga,14000000,12,0.025,350000,4200000,18200000
Lulut Yulianto,8000000,6,0.025,200000,1200000,9200000
Karma Saragih,9000000,6,0.025,225000,1350000,10350000
Wardi Permadi,6000000,6,0.025,150000,900000,6900000
Wulandari Mustika,9000000,12,0.025,225000,2700000,11700000
Asmuni Simanjuntak,20000000,12,0.035,700000,8400000,28400000
Salman Permadi,15000000,6,0.035,525000,3150000,18150000
Warsa Hidayanto,6000000,6,0.025,150000,900000,6900000
Eman Pratama,11000000,3,0.025,275000,825000,11825000
Tantri Purnama,18000000,3,0.015,270000,810000,18810000
Kurnia Natsir,20000000,12,0.015,300000,3600000,23600000
Rina Anandya,18000000,6,0.035,630000,3780000,21780000
Pratiwi Mardhiyah,5000000,3,0.025,125000,375000,5375000
Rusman Abimanyu,11000000,3,0.025,275000,825000,11825000
Harsana Budiyanto,10000000,12,0.025,250000,3000000,13000000
Nasab Rajasa,7000000,3,0.03,210000,630000,7630000
Bahuwirya Hutasoit,6000000,6,0.025,150000,900000,6900000
Daliman Maulana,17000000,6,0.015,255000,1530000,18530000
Jamalia Prastuti,19000000,3,0.025,475000,1425000,20425000
Anita Wahyuni,9000000,3,0.02,180000,540000,9540000
Aswani Prayoga,19000000,3,0.02,380000,1140000,20140000
Radika Tarihoran,15000000,3,0.025,375000,1125000,16125000
Hamzah Maheswara,17000000,6,0.015,255000,1530000,18530000
Ami Afifah,19000000,3,0.025,475000,1425000,20425000
Lala Lailasari,12000000,6,0.025,300000,1800000,13800000
Agus Simanjuntak,18000000,6,0.015,270000,1620000,19620000
Rahayu Suryatmi,18000000,12,0.015,270000,3240000,21240000
Hasta Samosir,20000000,12,0.025,500000,6000000,26000000
Jamil Prasetya,14000000,6,0.025,350000,2100000,16100000
Jefri Nugroho,15000000,6,0.015,225000,1350000,16350000
Jessica Mulyani,18000000,12,0.025,450000,5400000,23400000
Najam Saputra,11000000,6,0.02,220000,1320000,12320000
Devi Laksmiwati,12000000,12,0.025,300000,3600000,15600000
Cakrawangsa Rajasa,8000000,6,0.015,120000,720000,8720000
Kardi Adhitama,16000000,12,0.035,560000,6720000,22720000
Joko Sabian,10000000,6,0.025,250000,1500000,11500000
Taufan Rayhan,18000000,6,0.025,450000,2700000,20700000
Tantri Nathania,20000000,6,0.025,500000,3000000,23000000
Warji Haikal,15000000,6,0.035,525000,3150000,18150000
Purwa Damanik,15000000,3,0.03,450000,1350000,16350000
Marsito Rajata,6000000,12,0.025,150000,1800000,7800000
Tsabita Salma,17000000,3,0.03,510000,1530000,18530000
Julia Laksita,17000000,3,0.03,510000,1530000,18530000
Limar Siregar,19000000,6,0.02,380000,2280000,21280000
Ibrahim Santoso,14000000,3,0.015,210000,630000,14630000
Lalita Yolanda,12000000,6,0.025,300000,1800000,13800000
Saadat Alamsyah,10000000,6,0.02,200000,1200000,11200000
Kemba Uwais,6000000,3,0.035,210000,630000,6630000
Jumari Maheswara,12000000,12,0.025,300000,3600000,15600000
Budi Rayhan,5000000,3,0.025,125000,375000,5375000
Bakti Rajasa,20000000,12,0.025,500000,6000000,26000000
Jasmani Salahudin,19000000,6,0.02,380000,2280000,21280000
Kawaya Aswandi,19000000,6,0.03,570000,3420000,22420000
Balangga Natsir,9000000,6,0.02,180000,1080000,10080000
Koko Sihombing,7000000,6,0.025,175000,1050000,8050000
Kuncara Salahudin,10000000,6,0.025,250000,1500000,11500000
Purwa Pranowo,14000000,12,0.035,490000,5880000,19880000
Jarwi Wardana,17000000,3,0.025,425000,1275000,18275000
Karta Pranowo,17000000,3,0.015,255000,765000,17765000
Galak Utama,7000000,3,0.025,175000,525000,7525000
Tri Siregar,7000000,3,0.035,245000,735000,7735000
Marwata Saragih,11000000,6,0.03,330000,1980000,12980000
Cawisadi Rendra,11000000,3,0.035,385000,1155000,12155000
Cakrawangsa Wibowo,10000000,6,0.02,200000,1200000,11200000
Lintang Farida,17000000,12,0.025,425000,5100000,22100000
Kuncara Arifin,8000000,6,0.035,280000,1680000,9680000
Harja Adhitama,20000000,3,0.02,400000,1200000,21200000
Nyoman Iswahyudi,20000000,6,0.025,500000,3000000,23000000
Aisyah Mayasari,14000000,3,0.035,490000,1470000,15470000
Hasan Ardana,7000000,6,0.035,245000,1470000,8470000
Surya Marbun,8000000,6,0.025,200000,1200000,9200000
Kayla Ningrum,9000000,6,0.035,315000,1890000,10890000
Adika Kuswoyo,8000000,3,0.025,200000,600000,8600000
Kamila Pertiwi,10000000,3,0.025,250000,750000,10750000
Limar Hutagalung,15000000,6,0.02,300000,1800000,16800000
Kajen Wasita,9000000,12,0.025,225000,2700000,11700000
Vino Saefullah,10000000,6,0.025,250000,1500000,11500000
Gaduh Maryadi,11000000,6,0.025,275000,1650000,12650000
Ajimin Wasita,19000000,12,0.025,475000,5700000,24700000
Artanto Rahardian,20000000,3,0.02,400000,1200000,21200000
Jatmiko Oktavian,20000000,12,0.03,600000,7200000,27200000
Harimurti Hardiansyah,11000000,6,0.025,275000,1650000,12650000
Wawan Fabian,18000000,3,0.03,540000,1620000,19620000
Jarwadi Hardiansyah,11000000,6,0.025,275000,1650000,12650000
Jefri Yulianto,12000000,6,0.025,300000,1800000,13800000
Nabila Damayanti,16000000,6,0.035,560000,3360000,19360000
Jaka Suwarno,12000000,12,0.02,240000,2880000,14880000
Banawi Sihotang,11000000,6,0.035,385000,2310000,13310000
Betania Agustina,7000000,6,0.025,175000,1050000,8050000
Argono Rajasa,19000000,6,0.015,285000,1710000,20710000
Bella Fathina,5000000,3,0.015,75000,225000,5225000
Kamidin Pradana,7000000,12,0.025,175000,2100000,9100000
Digdaya Arifin,9000000,3,0.035,315000,945000,9945000
Chelsea Namaga,18000000,3,0.025,450000,1350000,19350000
Banawi Rayhan,18000000,6,0.035,630000,3780000,21780000
Gilang Haryanto,19000000,3,0.035,665000,1995000,20995000
Damar Sabian,20000000,3,0.03,600000,1800000,21800000
Fara Anjani,11000000,6,0.025,275000,1650000,12650000
Dariati Yanuar,9000000,6,0.035,315000,1890000,10890000
Mahesa Simbolon,7000000,3,0.02,140000,420000,7420000
Ganesha Rahmawati,16000000,12,0.025,400000,4800000,20800000
Paramita Kusmawati,14000000,6,0.03,420000,2520000,16520000
Pardi Pradipta,9000000,12,0.03,270000,3240000,12240000
Cakrawangsa Napitupulu,6000000,6,0.025,150000,900000,6900000
Puspa Leilani,7000000,3,0.025,175000,525000,7525000
Wardi Syahreza,6000000,6,0.03,180000,1080000,7080000
Dasa Najmudin,8000000,3,0.025,200000,600000,8600000
Jail Fabian,20000000,12,0.035,700000,8400000,28400000
Lulut Irawan,20000000,12,0.025,500000,6000000,26000000
Sabri Ardana,14000000,6,0.035,490000,2940000,16940000
Ghaliyati Lailasari,7000000,6,0.025,175000,1050000,8050000
Melani Nathania,8000000,12,0.02,160000,1920000,9920000
Enteng Kuswoyo,9000000,6,0.025,225000,1350000,10350000
Maryadi Siregar,8000000,6,0.02,160000,960000,8960000
Aulia Hassanah,10000000,3,0.025,250000,750000,10750000
Umar Handoko,15000000,6,0.035,525000,3150000,18150000
Belinda Putri,9000000,3,0.035,315000,945000,9945000
Dariati Yulianto,10000000,3,0.03,300000,900000,10900000
Viman Sabian,11000000,6,0.015,165000,990000,11990000
Damar Aswandi,19000000,6,0.035,665000,3990000,22990000
Radit Herlambang,20000000,12,0.025,500000,6000000,26000000
Gantar Saptono,20000000,6,0.035,700000,4200000,24200000
Zalindra Nasyiah,11000000,3,0.025,275000,825000,11825000
Raina Laksmiwati,18000000,6,0.035,630000,3780000,21780000
Utama Putra,11000000,12,0.025,275000,3300000,14300000
Bella Maryati,12000000,6,0.025,300000,1800000,13800000
Opan Airlangga,16000000,3,0.025,400000,1200000,17200000
Jarwa Herlambang,12000000,6,0.015,180000,1080000,13080000
Amalia Widiastuti,11000000,12,0.02,220000,2640000,13640000
Yulia Salma,7000000,6,0.025,175000,1050000,8050000
Mulya Narpati,19000000,6,0.025,475000,2850000,21850000
Ade Narpati,5000000,6,0.015,75000,450000,5450000
Dwi Oktaviani,7000000,3,0.02,140000,420000,7420000
Jamil Purnawarman,9000000,6,0.03,270000,1620000,10620000
Kasiyah Rachmawati,18000000,12,0.025,450000,5400000,23400000
Bakiman Wibisono,18000000,3,0.02,360000,1080000,19080000
Digdaya Himawan,19000000,3,0.035,665000,1995000,20995000
Raditya Alamsyah,20000000,6,0.035,700000,4200000,24200000
Wardi Purnama,11000000,6,0.02,220000,1320000,12320000
Gibran Anggriawan,9000000,6,0.025,225000,1350000,10350000
Melinda Putri,7000000,6,0.02,140000,840000,7840000
Vera Yuliarti,16000000,3,0.025,400000,1200000,17200000
Chelsea Widiastuti,14000000,12,0.015,210000,2520000,16520000
Safina Usamah,9000000,12,0.035,315000,3780000,12780000
Anom Sitompul,6000000,12,0.025,150000,1800000,7800000
Dipa Kurniawan,7000000,6,0.02,140000,840000,7840000
Daryani Febian,6000000,6,0.03,180000,1080000,7080000
Panji Mandala,11000000,12,0.035,385000,4620000,15620000
Harjo Prasetya,7000000,12,0.015,105000,1260000,8260000
Eja Sabian,19000000,6,0.03,570000,3420000,22420000
Ajiman Waluyo,5000000,6,0.025,125000,750000,5750000
Samiah Anjani,7000000,6,0.025,175000,1050000,8050000
Puspa Handayani,9000000,3,0.02,180000,540000,9540000
Amalia Laksita,18000000,12,0.025,450000,5400000,23400000
Maya Juwita,18000000,3,0.015,270000,810000,18810000
Gaiman Natsir,19000000,6,0.025,475000,2850000,21850000
Pangestu Pradana,20000000,6,0.025,500000,3000000,23000000
Warji Wacana,11000000,12,0.025,275000,3300000,14300000
Yono Maheswara,9000000,12,0.02,180000,2160000,11160000
Nyoman Herlambang,7000000,3,0.025,175000,525000,7525000
Kiandra Saputri,16000000,12,0.025,400000,4800000,20800000
Dodo Pradana,14000000,3,0.02,280000,840000,14840000
Mumpuni Maulana,9000000,3,0.035,315000,945000,9945000
Taufan Maryadi,6000000,6,0.025,150000,900000,6900000
Prabawa Wasita,7000000,3,0.015,105000,315000,7315000
Rudi Sihombing,6000000,3,0.025,150000,450000,6450000
Prakosa Nanda,9000000,6,0.03,270000,1620000,10620000
Ivan Sabian,18000000,6,0.015,270000,1620000,19620000
Yessi Fathina,18000000,3,0.015,270000,810000,18810000
Karja Lazuardi,19000000,6,0.02,380000,2280000,21280000
Gasti Harini,20000000,6,0.025,500000,3000000,23000000
Danang Dirgantara,11000000,6,0.035,385000,2310000,13310000
Oman Simanjuntak,9000000,3,0.02,180000,540000,9540000
Tina Hassanah,7000000,12,0.035,245000,2940000,9940000
Halima Rahmawati,16000000,6,0.035,560000,3360000,19360000
Kania Uyainah,14000000,3,0.025,350000,1050000,15050000
Ina Fathina,9000000,3,0.03,270000,810000,9810000
Pandu Adriansyah,6000000,3,0.03,180000,540000,6540000
Cawisadi Irfandi,7000000,6,0.025,175000,1050000,8050000
Tugiman Natsir,6000000,12,0.025,150000,1800000,7800000
Enteng Oktavian,8000000,6,0.035,280000,1680000,9680000
Cahya Haryanto,20000000,3,0.025,500000,1500000,21500000
Mustika Handoko,20000000,3,0.035,700000,2100000,22100000
Hardana Thamrin,14000000,3,0.025,350000,1050000,15050000
Emas Kuswoyo,7000000,3,0.02,140000,420000,7420000
Siti Zulaika,8000000,3,0.015,120000,360000,8360000
Ganesha Yuniar,9000000,12,0.015,135000,1620000,10620000
Banawa Kusumo,8000000,3,0.015,120000,360000,8360000
Maras Yulianto,10000000,3,0.035,350000,1050000,11050000
Sadina Afifah,15000000,12,0.02,300000,3600000,18600000
Banawa Syahreza,9000000,3,0.03,270000,810000,9810000
Hendra Sabian,10000000,12,0.035,350000,4200000,14200000
Amalia Prastuti,11000000,6,0.025,275000,1650000,12650000
Salimah Aurelia,19000000,6,0.03,570000,3420000,22420000
Harimurti Satria,20000000,12,0.035,700000,8400000,28400000
Bala Perdana,20000000,12,0.015,300000,3600000,23600000
Icha Usada,11000000,3,0.02,220000,660000,11660000
Olivia Afifah,18000000,6,0.025,450000,2700000,20700000
Daryani Saputra,11000000,6,0.025,275000,1650000,12650000
Kajen Simanjuntak,12000000,6,0.025,300000,1800000,13800000
Tami Hassanah,16000000,3,0.025,400000,1200000,17200000
Akarsana Lazuardi,12000000,3,0.035,420000,1260000,13260000
Catur Rahardian,11000000,12,0.025,275000,3300000,14300000
Paramita Fernanda,7000000,6,0.015,105000,630000,7630000
Nur Fathina,19000000,6,0.035,665000,3990000,22990000
Karen Winarsih,5000000,3,0.02,100000,300000,5300000
Gibran Wicaksono,7000000,3,0.03,210000,630000,7630000
Gandewa Yulianto,11000000,6,0.025,275000,1650000,12650000
Mujur Sihotang,18000000,6,0.025,450000,2700000,20700000
Maryadi Januar,11000000,6,0.025,275000,1650000,12650000
Galak Nugroho,12000000,6,0.015,180000,1080000,13080000
Martani Tampubolon,16000000,6,0.025,400000,2400000,18400000
Hendra Maryadi,12000000,6,0.015,180000,1080000,13080000
Lutfan Oktovian,11000000,3,0.025,275000,825000,11825000
Wasis Firmansyah,7000000,3,0.03,210000,630000,7630000
Capa Simbolon,19000000,6,0.025,475000,2850000,21850000
Tugiman Sihotang,5000000,3,0.025,125000,375000,5375000
Maryadi Januar,7000000,12,0.035,245000,2940000,9940000
Bakianto Permadi,5000000,6,0.035,175000,1050000,6050000
Puji Afifah,7000000,3,0.015,105000,315000,7315000
Harjo Pangestu,9000000,6,0.03,270000,1620000,10620000
Nilam Haryanti,18000000,3,0.03,540000,1620000,19620000
Uli Prastuti,18000000,3,0.025,450000,1350000,19350000
Rizki Nababan,19000000,3,0.035,665000,1995000,20995000
Pia Purnawati,20000000,3,0.02,400000,1200000,21200000
Jais Suryono,11000000,6,0.025,275000,1650000,12650000
Septi Aryanti,9000000,6,0.025,225000,1350000,10350000
Rina Usamah,7000000,6,0.035,245000,1470000,8470000
Mariadi Sitompul,16000000,3,0.025,400000,1200000,17200000
Purwa Lazuardi,14000000,6,0.025,350000,2100000,16100000
Dadi Arifin,9000000,6,0.015,135000,810000,9810000
Perkasa Kurniawan,6000000,6,0.015,90000,540000,6540000
Fitri Safitri,7000000,12,0.02,140000,1680000,8680000
Artanto Samosir,6000000,3,0.02,120000,360000,6360000
Kamila Laksita,9000000,6,0.025,225000,1350000,10350000
Jumari Yanuar,18000000,6,0.015,270000,1620000,19620000
Balapati Simbolon,18000000,12,0.035,630000,7560000,25560000
Noviana Fujiati,19000000,6,0.025,475000,2850000,21850000
Ikin Pradana,20000000,6,0.015,300000,1800000,21800000
Omar Pradana,11000000,6,0.025,275000,1650000,12650000
Saka Herlambang,9000000,6,0.035,315000,1890000,10890000
Prayogo Waskita,7000000,12,0.025,175000,2100000,9100000
Warsa Marbun,16000000,12,0.035,560000,6720000,22720000
Yoga Firgantoro,14000000,12,0.03,420000,5040000,19040000
Legawa Prasetya,9000000,12,0.025,225000,2700000,11700000
Hardana Nainggolan,6000000,3,0.025,150000,450000,6450000
Fitriani Zahrah,7000000,6,0.02,140000,840000,7840000
Vino Siregar,6000000,3,0.03,180000,540000,6540000
Kala Iswahyudi,8000000,6,0.03,240000,1440000,9440000
Sidiq Faresta,20000000,3,0.035,700000,2100000,22100000
Lala Melani,20000000,6,0.025,500000,3000000,23000000
Muhammad Alamsyah,14000000,6,0.025,350000,2100000,16100000
Nasim Mandala,7000000,3,0.025,175000,525000,7525000
Muhammad Purwadi,8000000,6,0.015,120000,720000,8720000
Julia Elvina,9000000,3,0.02,180000,540000,9540000
Atmaja Ramadan,8000000,12,0.035,280000,3360000,11360000
Raihan Budiyanto,10000000,6,0.025,250000,1500000,11500000
Mariadi Antoni,15000000,12,0.02,300000,3600000,18600000
Legawa Suryono,9000000,6,0.025,225000,1350000,10350000
Martana Saefullah,10000000,3,0.035,350000,1050000,11050000
Karsa Perdana,11000000,6,0.015,165000,990000,11990000
Karsana Sihombing,19000000,12,0.025,475000,5700000,24700000
Gara Hutapea,20000000,3,0.035,700000,2100000,22100000
Hendri Prabowo,16000000,12,0.025,400000,4800000,20800000
Gasti Ananda,10000000,6,0.025,250000,1500000,11500000
Ami Suryatmi,18000000,6,0.02,360000,2160000,20160000
Fara Nasyiah,20000000,3,0.015,300000,900000,20900000
Titin Jelita,15000000,12,0.025,375000,4500000,19500000
Martana Hermawan,15000000,3,0.035,525000,1575000,16575000
Sasha Wulandari,6000000,3,0.015,90000,270000,6270000
Nadine Zulaika,17000000,3,0.02,340000,1020000,18020000
Banawa Prasasta,17000000,3,0.015,255000,765000,17765000
Himawan Natsir,19000000,12,0.02,380000,4560000,23560000
Viktor Setiawan,14000000,3,0.035,490000,1470000,15470000
Gilang Irfandi,12000000,3,0.02,240000,720000,12720000
Ifa Rahayu,10000000,6,0.025,250000,1500000,11500000
Asmadi Purwadi,6000000,6,0.035,210000,1260000,7260000
Cakrawala Yulianto,12000000,12,0.02,240000,2880000,14880000
Ciaobella Mardhiyah,5000000,3,0.035,175000,525000,5525000
Laswi Irawan,20000000,3,0.025,500000,1500000,21500000
Tirta Irfandi,19000000,3,0.035,665000,1995000,20995000
Utama Hutagalung,19000000,12,0.02,380000,4560000,23560000
Rafi Halim,9000000,3,0.03,270000,810000,9810000
Ganda Sirait,7000000,12,0.035,245000,2940000,9940000
Paramita Mardhiyah,10000000,3,0.03,300000,900000,10900000
Wulandari Saputri,14000000,6,0.035,490000,2940000,16940000
Gangsa Handoko,17000000,3,0.02,340000,1020000,18020000
Fara Mardhiyah,17000000,6,0.035,595000,3570000,20570000
Kasiyah Mustika,7000000,12,0.025,175000,2100000,9100000
Anggun Laksmiwati,7000000,3,0.035,245000,735000,7735000
Bakiadi Setiawan,11000000,6,0.025,275000,1650000,12650000
Lembah Mansur,11000000,6,0.015,165000,990000,11990000
Yono Prabowo,10000000,6,0.035,350000,2100000,12100000
Nasim Firmansyah,17000000,3,0.02,340000,1020000,18020000
Cahya Prasetyo,8000000,12,0.025,200000,2400000,10400000
Sintia Kahyang,20000000,6,0.035,700000,4200000,24200000
Gangsa Wacana,20000000,6,0.025,500000,3000000,23000000
Yunita Usamah,14000000,6,0.02,280000,1680000,15680000
Sarah Laksita,7000000,3,0.025,175000,525000,7525000
Maryadi Hidayat,8000000,6,0.035,280000,1680000,9680000
Lasmono Sabian,9000000,6,0.035,315000,1890000,10890000
Wisnu Hutapea,8000000,6,0.035,280000,1680000,9680000
Wasis Dirgantara,10000000,3,0.015,150000,450000,10450000
Adika Irawan,15000000,6,0.035,525000,3150000,18150000
Fitri Anggraini,9000000,3,0.025,225000,675000,9675000
Rita Susanti,10000000,3,0.025,250000,750000,10750000
Prayogo Rajasa,11000000,3,0.025,275000,825000,11825000
Kayun Abiputra,19000000,3,0.015,285000,855000,19855000
Cahyadi Nanda,20000000,3,0.025,500000,1500000,21500000
Wawan Agustian,20000000,3,0.015,300000,900000,20900000
Yessi Mardhiyah,11000000,6,0.02,220000,1320000,12320000
Cemeti Budiyanto,18000000,6,0.025,450000,2700000,20700000
Nada Elvina,11000000,6,0.025,275000,1650000,12650000
Sari Kusuma,12000000,12,0.015,180000,2160000,14160000
Sakura Nasyiah,16000000,3,0.025,400000,1200000,17200000
Artanto Waskita,12000000,12,0.015,180000,2160000,14160000
Gambira Nainggolan,11000000,12,0.025,275000,3300000,14300000
Chelsea Mustika,7000000,6,0.025,175000,1050000,8050000
Nabila Hasanah,19000000,3,0.015,285000,855000,19855000
Joko Maulana,5000000,6,0.025,125000,750000,5750000
Ilsa Kusmawati,7000000,3,0.025,175000,525000,7525000
Dwi Hariyah,9000000,12,0.015,135000,1620000,10620000
Jagaraga Mangunsong,18000000,12,0.035,630000,7560000,25560000
Kalim Pangestu,18000000,6,0.015,270000,1620000,19620000
Luwar Ardana,19000000,12,0.025,475000,5700000,24700000
Nimas Mayasari,20000000,3,0.02,400000,1200000,21200000
Zulfa Amanta,11000000,3,0.025,275000,825000,11825000
Galih Narpati,9000000,3,0.015,135000,405000,9405000
Asirwanda Jailani,7000000,6,0.02,140000,840000,7840000
Wasis Sihombing,16000000,6,0.025,400000,2400000,18400000
Pratiwi Laksita,14000000,3,0.035,490000,1470000,15470000
Rita Aryanti,9000000,6,0.015,135000,810000,9810000
Wardi Pangestu,6000000,6,0.025,150000,900000,6900000
Karta Rendra,7000000,6,0.025,175000,1050000,8050000
Maras Sudrajat,6000000,6,0.025,150000,900000,6900000
Padmi Harini,8000000,3,0.035,280000,840000,8840000
Cecep Kusumo,20000000,3,0.025,500000,1500000,21500000
Zulaikha Nurdiyanti,20000000,6,0.03,600000,3600000,23600000
Cahya Simanjuntak,14000000,6,0.025,350000,2100000,16100000
Bakiono Wibisono,7000000,6,0.03,210000,1260000,8260000
Tasdik Yanuar,8000000,3,0.02,160000,480000,8480000
Rahman Purnama,9000000,6,0.035,315000,1890000,10890000
Nalar Wijaya,8000000,3,0.025,200000,600000,8600000
Kasusra Januar,10000000,6,0.025,250000,1500000,11500000
Mulya Darojat,15000000,3,0.015,225000,675000,15675000
Daliman Abiputra,9000000,6,0.015,135000,810000,9810000
Cengkal Gunarto,10000000,12,0.02,200000,2400000,12400000
Edward Januar,11000000,3,0.025,275000,825000,11825000
Gatra Zulkarnain,19000000,3,0.025,475000,1425000,20425000
Heryanto Situmorang,20000000,3,0.02,400000,1200000,21200000
Daliono Nugroho,20000000,6,0.015,300000,1800000,21800000
Cemani Hutagalung,11000000,3,0.025,275000,825000,11825000
Violet Hastuti,18000000,12,0.035,630000,7560000,25560000
Gasti Ramadhani,11000000,12,0.015,165000,1980000,12980000
Indah Fujiati,12000000,12,0.025,300000,3600000,15600000
Irsad Mandala,16000000,3,0.025,400000,1200000,17200000
Vino Wahyudin,12000000,3,0.02,240000,720000,12720000
Gasti Maryati,11000000,3,0.02,220000,660000,11660000
Hani Nathania,7000000,12,0.025,175000,2100000,9100000
Febriana Leilani,19000000,12,0.02,380000,4560000,23560000
Omar Sihombing,5000000,6,0.035,175000,1050000,6050000
Prasetyo Prabowo,7000000,6,0.025,175000,1050000,8050000
Padmi Palastri,9000000,3,0.02,180000,540000,9540000
Restu Pudjiastuti,18000000,3,0.035,630000,1890000,19890000
Laras Wahyuni,18000000,12,0.025,450000,5400000,23400000
Gatot Waskita,19000000,12,0.015,285000,3420000,22420000
Enteng Sinaga,20000000,12,0.025,500000,6000000,26000000
Karja Haikal,11000000,3,0.03,330000,990000,11990000
Gangsa Faresta,9000000,12,0.025,225000,2700000,11700000
Paiman Situmorang,7000000,6,0.025,175000,1050000,8050000
Karta Hakim,16000000,6,0.025,400000,2400000,18400000
Daliono Rahardian,14000000,12,0.035,490000,5880000,19880000
Cager Kusumo,9000000,6,0.025,225000,1350000,10350000
Damar Narpati,6000000,3,0.02,120000,360000,6360000
Ihsan Najmudin,7000000,12,0.035,245000,2940000,9940000
Cahyo Halim,6000000,6,0.035,210000,1260000,7260000
Kurnia Saptono,11000000,3,0.03,330000,990000,11990000
Humaira Aryanti,7000000,6,0.025,175000,1050000,8050000
Garda Purwadi,19000000,6,0.03,570000,3420000,22420000
Fara Maharani,5000000,6,0.025,125000,750000,5750000
Koko Maryadi,7000000,6,0.015,105000,630000,7630000
Jaswadi Pradipta,9000000,3,0.025,225000,675000,9675000
Warji Purnama,18000000,6,0.02,360000,2160000,20160000
Azalea Aqila,18000000,6,0.025,450000,2700000,20700000
Ilsa Melani,19000000,3,0.025,475000,1425000,20425000
Arsipatra Prasetya,20000000,3,0.035,700000,2100000,22100000
Ana Usada,11000000,6,0.035,385000,2310000,13310000
Fitri Kusuma,9000000,3,0.015,135000,405000,9405000
Lalita Nathania,7000000,12,0.035,245000,2940000,9940000
Unjani Sudiati,16000000,6,0.015,240000,1440000,17440000
Rini Pertiwi,14000000,3,0.03,420000,1260000,15260000
Prita Suartini,9000000,6,0.015,135000,810000,9810000
Asirwanda Mahendra,6000000,3,0.025,150000,450000,6450000
Tina Puspasari,7000000,6,0.015,105000,630000,7630000
Rudi Hutasoit,6000000,6,0.03,180000,1080000,7080000
Safira Yolanda,9000000,3,0.03,270000,810000,9810000
Darimin Samosir,18000000,3,0.025,450000,1350000,19350000
Atmaja Prayoga,18000000,6,0.015,270000,1620000,19620000
Ghaliyati Hasanah,19000000,6,0.035,665000,3990000,22990000
Gabriella Hastuti,20000000,6,0.025,500000,3000000,23000000
Ajiono Widodo,11000000,3,0.025,275000,825000,11825000
Patricia Aryanti,9000000,6,0.015,135000,810000,9810000
Kajen Sudrajat,7000000,6,0.03,210000,1260000,8260000
Iriana Susanti,16000000,3,0.035,560000,1680000,17680000
Dariati Thamrin,14000000,3,0.025,350000,1050000,15050000
Kezia Fernanda,9000000,6,0.025,225000,1350000,10350000
Rina Usamah,6000000,12,0.02,120000,1440000,7440000
Irfan Simbolon,7000000,12,0.035,245000,2940000,9940000
Lanang Widodo,6000000,12,0.015,90000,1080000,7080000
Putri Wijayanti,8000000,12,0.035,280000,3360000,11360000
Gilda Wijayanti,20000000,6,0.025,500000,3000000,23000000
Zizi Salsabilla,20000000,6,0.03,600000,3600000,23600000
Gaduh Prakasa,14000000,6,0.025,350000,2100000,16100000
Halima Pudjiastuti,7000000,3,0.03,210000,630000,7630000
Edward Iswahyudi,8000000,12,0.015,120000,1440000,9440000
Faizah Afifah,9000000,3,0.02,180000,540000,9540000
Bala Rendra,8000000,12,0.025,200000,2400000,10400000
Gantar Pradana,10000000,12,0.035,350000,4200000,14200000
Nabila Utami,15000000,6,0.02,300000,1800000,16800000
Tasnim Satria,9000000,3,0.015,135000,405000,9405000
Gada Mansur,10000000,12,0.025,250000,3000000,13000000
Warsa Permadi,11000000,12,0.015,165000,1980000,12980000
Latif Arifin,19000000,6,0.03,570000,3420000,22420000
Maras Sirait,20000000,3,0.035,700000,2100000,22100000
Balamantri Saputra,20000000,12,0.02,400000,4800000,24800000
Raisa Halimah,11000000,6,0.015,165000,990000,11990000
Rahmawati Jelita,18000000,6,0.035,630000,3780000,21780000
Damar Purnawarman,11000000,3,0.03,330000,990000,11990000
Kemba Bagaskara,12000000,6,0.025,300000,1800000,13800000
Gaduh Saefullah,16000000,6,0.035,560000,3360000,19360000
Ade Megantara,12000000,12,0.025,300000,3600000,15600000
Hendra Pratama,11000000,3,0.025,275000,825000,11825000
Gaman Marbun,7000000,6,0.015,105000,630000,7630000
Rosa Hassanah,19000000,12,0.02,380000,4560000,23560000
Bagas Nugraha,5000000,6,0.025,125000,750000,5750000
Fitri Ramadhani,7000000,6,0.035,245000,1470000,8470000
Edward Sihombing,11000000,12,0.025,275000,3300000,14300000
Yunita Zahrah,18000000,12,0.02,360000,4320000,22320000
Sabrina Hasanah,11000000,3,0.025,275000,825000,11825000
Lega Januar,12000000,12,0.025,300000,3600000,15600000
Violet Nasyiah,16000000,12,0.025,400000,4800000,20800000
Asmianto Natsir,12000000,12,0.035,420000,5040000,17040000
Wasis Hermawan,11000000,3,0.025,275000,825000,11825000
Ikin Mahendra,7000000,3,0.015,105000,315000,7315000
Virman Kusumo,19000000,6,0.025,475000,2850000,21850000
Ibun Aswandi,5000000,3,0.015,75000,225000,5225000
Jaka Hutapea,7000000,6,0.035,245000,1470000,8470000
Nimas Prastuti,7000000,12,0.035,245000,2940000,9940000
Maria Farida,6000000,3,0.015,90000,270000,6270000
Fara Hastuti,8000000,12,0.03,240000,2880000,10880000
Dinda Fathina,20000000,6,0.025,500000,3000000,23000000
Maman Simbolon,20000000,6,0.035,700000,4200000,24200000
Mulyono Suwarno,14000000,6,0.02,280000,1680000,15680000
Baktianto Purwadi,7000000,3,0.03,210000,630000,7630000
Kanda Hardiansyah,8000000,6,0.025,200000,1200000,9200000
Harja Rahardian,9000000,6,0.025,225000,1350000,10350000
Indra Narpati,8000000,6,0.015,120000,720000,8720000
Mustofa Supriyanto,10000000,3,0.025,250000,750000,10750000
Almira Aryanti,15000000,6,0.03,450000,2700000,17700000
Eluh Permadi,9000000,12,0.035,315000,3780000,12780000
Rahayu Fathina,10000000,6,0.025,250000,1500000,11500000
Candra Napitupulu,11000000,12,0.025,275000,3300000,14300000
Umi Rahayu,19000000,3,0.015,285000,855000,19855000
Lasmanto Hutapea,20000000,6,0.03,600000,3600000,23600000
Saka Prakasa,16000000,3,0.035,560000,1680000,17680000
Paiman Hakim,10000000,3,0.035,350000,1050000,11050000
Cager Mansur,18000000,6,0.025,450000,2700000,20700000
Niyaga Hardiansyah,20000000,3,0.025,500000,1500000,21500000
Jinawi Mansur,15000000,6,0.025,375000,2250000,17250000
Darmanto Habibi,15000000,6,0.025,375000,2250000,17250000
Galuh Waluyo,6000000,3,0.02,120000,360000,6360000
Latif Suryono,17000000,6,0.025,425000,2550000,19550000
Kajen Nugroho,17000000,6,0.025,425000,2550000,19550000
Ditya Lestari,19000000,6,0.025,475000,2850000,21850000
Silvia Haryanti,14000000,6,0.02,280000,1680000,15680000
Ajiono Sitorus,12000000,6,0.02,240000,1440000,13440000
Hilda Putri,10000000,3,0.015,150000,450000,10450000
Anom Prasasta,6000000,12,0.025,150000,1800000,7800000
Gambira Abimanyu,12000000,6,0.02,240000,1440000,13440000
Lukita Mangunsong,5000000,12,0.025,125000,1500000,6500000
Karman Airlangga,20000000,12,0.035,700000,8400000,28400000
Sasha Purwanti,19000000,6,0.025,475000,2850000,21850000
Azalea Ningrum,19000000,6,0.02,380000,2280000,21280000
Cakrawangsa Hutagalung,9000000,6,0.025,225000,1350000,10350000
Wage Uwais,7000000,12,0.025,175000,2100000,9100000
Dimas Hidayanto,10000000,3,0.015,150000,450000,10450000
Hendra Wardana,14000000,3,0.025,350000,1050000,15050000
Cornelia Leilani,17000000,6,0.02,340000,2040000,19040000
Garda Sihotang,17000000,6,0.02,340000,2040000,19040000
Virman Marbun,7000000,6,0.02,140000,840000,7840000
Jono Prasetya,7000000,6,0.035,245000,1470000,8470000
Darmaji Hidayanto,11000000,6,0.025,275000,1650000,12650000
Vera Purnama,11000000,12,0.015,165000,1980000,12980000
Hari Saputra,10000000,3,0.03,300000,900000,10900000
Harjaya Utama,17000000,3,0.015,255000,765000,17765000
Leo Nashiruddin,8000000,6,0.02,160000,960000,8960000
Kayla Zulaika,20000000,12,0.025,500000,6000000,26000000
Dodo Marbun,20000000,6,0.015,300000,1800000,21800000
Prakosa Rayhan,14000000,6,0.03,420000,2520000,16520000
Yosef Samosir,7000000,12,0.025,175000,2100000,9100000
Purwa Mahendra,8000000,12,0.025,200000,2400000,10400000
Elvin Lazuardi,9000000,12,0.035,315000,3780000,12780000
Mumpuni Marbun,8000000,3,0.025,200000,600000,8600000
Kawaca Hidayat,10000000,6,0.02,200000,1200000,11200000
Mahdi Ramadan,15000000,12,0.025,375000,4500000,19500000
Kasusra Rayhan,9000000,6,0.025,225000,1350000,10350000
Prakosa Yudhistira,10000000,6,0.025,250000,1500000,11500000
Yance Putri,11000000,3,0.02,220000,660000,11660000
Leo Haryanto,19000000,6,0.035,665000,3990000,22990000
Aditya Purwadi,20000000,3,0.025,500000,1500000,21500000
Yoga Pradana,20000000,12,0.025,500000,6000000,26000000
Farhunnisa Aryani,11000000,6,0.025,275000,1650000,12650000
Kartika Wahyuni,18000000,3,0.025,450000,1350000,19350000
Padmi Saputri,11000000,6,0.035,385000,2310000,13310000
Vanesa Andini,12000000,6,0.025,300000,1800000,13800000
Juli Namaga,16000000,6,0.015,240000,1440000,17440000
Fitriani Damayanti,12000000,12,0.015,180000,2160000,14160000
Gadis Maryati,11000000,6,0.025,275000,1650000,12650000
Aulia Rahimah,7000000,3,0.02,140000,420000,7420000
Manah Hutasoit,19000000,3,0.02,380000,1140000,20140000
Hasim Mahendra,5000000,6,0.03,150000,900000,5900000
Luis Wasita,7000000,3,0.02,140000,420000,7420000
Cici Anggraini,9000000,3,0.025,225000,675000,9675000
Atmaja Aswandi,18000000,6,0.025,450000,2700000,20700000
Umay Hutasoit,18000000,12,0.025,450000,5400000,23400000
Karsa Supriyanto,19000000,6,0.015,285000,1710000,20710000
Tasnim Megantara,20000000,6,0.03,600000,3600000,23600000
Belinda Rahmawati,11000000,6,0.025,275000,1650000,12650000
Lili Usamah,9000000,6,0.035,315000,1890000,10890000
Rafid Satria,7000000,6,0.02,140000,840000,7840000
Gambira Mustofa,16000000,12,0.03,480000,5760000,21760000
Setya Hermawan,14000000,12,0.025,350000,4200000,18200000
Pardi Purwadi,9000000,6,0.025,225000,1350000,10350000
Johan Yulianto,6000000,3,0.035,210000,630000,6630000
Harjaya Fabian,7000000,12,0.015,105000,1260000,8260000
Mursita Alamsyah,6000000,3,0.025,150000,450000,6450000
Kayun Wacana,8000000,3,0.035,280000,840000,8840000
Usman Alamsyah,20000000,6,0.025,500000,3000000,23000000
Ade Pratama,20000000,6,0.025,500000,3000000,23000000
Arta Aswandi,14000000,12,0.025,350000,4200000,18200000
Warji Yanuar,7000000,6,0.025,175000,1050000,8050000
Taufik Saefullah,8000000,3,0.025,200000,600000,8600000
Martani Pangestu,9000000,12,0.02,180000,2160000,11160000
Pangestu Hardiansyah,8000000,3,0.03,240000,720000,8720000
Darmaji Tarihoran,10000000,3,0.025,250000,750000,10750000
Gatot Permadi,15000000,12,0.025,375000,4500000,19500000
Budi Utama,9000000,6,0.03,270000,1620000,10620000
Mulya Suryono,10000000,6,0.015,150000,900000,10900000
Bakiman Purwadi,11000000,6,0.035,385000,2310000,13310000
Taswir Wibowo,19000000,3,0.035,665000,1995000,20995000
Mujur Yudhistira,20000000,6,0.015,300000,1800000,21800000
Mulya Alamsyah,20000000,12,0.025,500000,6000000,26000000
Kamila Nurdiyanti,11000000,3,0.025,275000,825000,11825000
Almira Susanti,18000000,6,0.015,270000,1620000,19620000
Lantar Haikal,11000000,3,0.025,275000,825000,11825000
Oskar Marbun,12000000,6,0.02,240000,1440000,13440000
Kemba Mansur,16000000,6,0.025,400000,2400000,18400000
Estiono Herlambang,12000000,6,0.025,300000,1800000,13800000
Umay Haryanto,11000000,12,0.025,275000,3300000,14300000
Kezia Fernanda,7000000,3,0.02,140000,420000,7420000
Pratiwi Puspasari,19000000,6,0.025,475000,2850000,21850000
Kayun Tamba,5000000,12,0.025,125000,1500000,6500000
Najwa Rahimah,7000000,12,0.015,105000,1260000,8260000
Icha Hassanah,9000000,3,0.025,225000,675000,9675000
Dadi Purwadi,18000000,6,0.025,450000,2700000,20700000
Cahyo Prasetya,18000000,6,0.035,630000,3780000,21780000
Prabu Febian,19000000,3,0.035,665000,1995000,20995000
Pandu Samosir,20000000,6,0.015,300000,1800000,21800000
Pandu Syahreza,11000000,6,0.035,385000,2310000,13310000
Niyaga Pradipta,9000000,6,0.025,225000,1350000,10350000
Waluyo Napitupulu,7000000,12,0.035,245000,2940000,9940000
Jasmani Manullang,16000000,6,0.035,560000,3360000,19360000
Rahayu Winarsih,14000000,6,0.035,490000,2940000,16940000
Anita Nurlaela,9000000,6,0.025,225000,1350000,10350000
Prita Laksmiwati,6000000,6,0.035,210000,1260000,7260000
Reza Irawan,7000000,3,0.025,175000,525000,7525000
Lembah Suwarno,6000000,6,0.025,150000,900000,6900000
Nimas Winarsih,11000000,3,0.025,275000,825000,11825000
Rosa Kuswandari,7000000,3,0.02,140000,420000,7420000
Hartaka Pratama,19000000,3,0.035,665000,1995000,20995000
Kamaria Handayani,5000000,12,0.035,175000,2100000,7100000
Candra Syahreza,7000000,3,0.025,175000,525000,7525000
Setya Abiputra,9000000,3,0.025,225000,675000,9675000
Kani Hariyah,18000000,12,0.025,450000,5400000,23400000
Oskar Ardianto,18000000,6,0.02,360000,2160000,20160000
Fathonah Widiastuti,19000000,12,0.025,475000,5700000,24700000
Luluh Natsir,20000000,6,0.025,500000,3000000,23000000
Siska Hassanah,11000000,12,0.035,385000,4620000,15620000
Tirta Prabowo,9000000,3,0.02,180000,540000,9540000
Tari Maryati,7000000,12,0.035,245000,2940000,9940000
Digdaya Lesmana,16000000,6,0.035,560000,3360000,19360000
Diana Andriani,14000000,6,0.03,420000,2520000,16520000
Kayla Pertiwi,9000000,12,0.035,315000,3780000,12780000
Cawuk Halim,6000000,3,0.035,210000,630000,6630000
Karma Abimanyu,7000000,6,0.03,210000,1260000,8260000
Vera Fernanda,6000000,6,0.02,120000,720000,6720000
Ratna Damayanti,9000000,6,0.02,180000,1080000,10080000
Elvina Usamah,18000000,6,0.02,360000,2160000,20160000
Eko Zulkarnain,18000000,3,0.035,630000,1890000,19890000
Indah Mulyani,19000000,3,0.025,475000,1425000,20425000
Gilda Pertiwi,20000000,3,0.025,500000,1500000,21500000
Mulyono Marbun,11000000,12,0.03,330000,3960000,14960000
Retno Yolanda,9000000,3,0.025,225000,675000,9675000
Zamira Damayanti,7000000,3,0.02,140000,420000,7420000
Salman Lesmana,16000000,3,0.025,400000,1200000,17200000
Bagya Hutasoit,14000000,3,0.025,350000,1050000,15050000
Raditya Abimanyu,9000000,6,0.015,135000,810000,9810000
Nasrullah Sihotang,6000000,6,0.025,150000,900000,6900000
Mala Fathina,7000000,12,0.025,175000,2100000,9100000
Indah Wulandari,6000000,6,0.03,180000,1080000,7080000
Alambana Wahyudin,8000000,3,0.035,280000,840000,8840000
Eko Nababan,20000000,3,0.03,600000,1800000,21800000
Latika Kusuma,20000000,3,0.025,500000,1500000,21500000
Jindra Wijaya,14000000,12,0.02,280000,3360000,17360000
Najam Sitorus,7000000,12,0.03,210000,2520000,9520000
Bala Mustofa,8000000,3,0.03,240000,720000,8720000
Violet Lailasari,9000000,6,0.02,180000,1080000,10080000
Ifa Farida,8000000,6,0.025,200000,1200000,9200000
Margana Wibisono,10000000,6,0.025,250000,1500000,11500000
Cahyadi Suwarno,15000000,6,0.025,375000,2250000,17250000
Kunthara Widodo,9000000,12,0.02,180000,2160000,11160000
Gilda Mandasari,10000000,6,0.03,300000,1800000,11800000
Wardaya Napitupulu,11000000,6,0.025,275000,1650000,12650000
Dina Astuti,19000000,3,0.025,475000,1425000,20425000
Tirtayasa Maulana,20000000,6,0.025,500000,3000000,23000000
Sakti Agustian,20000000,6,0.035,700000,4200000,24200000
Fathonah Damayanti,11000000,12,0.03,330000,3960000,14960000
Luwar Yanuar,18000000,6,0.035,630000,3780000,21780000
Natalia Susanti,11000000,6,0.025,275000,1650000,12650000
Kairav Yulianto,12000000,12,0.025,300000,3600000,15600000
